border_size=1
usage=map

Hhd, Hhd, Md, Md, Md, Hhd, Md, Hhd, Hhd, Hhd, Hhd, Dd, Dd, Dd, Dd, Dd, Dd, Dd, Dd, Dd, Dd, Dd, Dd, Dd, Dd, Dd, Dd, Dd, Dd, Dd, Dd, Dd, Dd, Dd, Dd, Dd, Dd, Dd, Dd, Dd, Dd, Dd, Dd, Dd, Hd, Hd, Hd, Hd, Hd, Dd, Hd, Dd, Dd, Dd, Dd, Hd, Hd, Hd, Dd, Dd, Hd, Hd
Hhd, Md, Hhd, Md, Md, Md, Md, Md, Hhd, Hhd, Hhd, Dd, Hhd, Hhd, Dd, Dd, Dd, Dd, Dd, Dd, Dd, Dd, Dd, Dd, Dd, Dd, Dd, Dd, Dd, Dd, Dd, Dd, Dd, Dd, Dd, Dd, Dd, Dd^Edp, Dd, Dd, Dd^Edp, Dd, Hd, Hd, Hhd, Hd, Hhd, Hhd, Hd, Dd, Hd, Dd^Edp, Dd, Dd, Dd, Hd, Hd, Hd, Dd, Dd, Hd, Hd
Hhd, Hhd, Hhd, Md, Md, Md, Md, Md, Md, Hhd, Hhd, Hhd, Hd, Hd, Hd, Dd, Dd, Dd, Dd, Dd, Dd, Dd, Dd, Dd, Dd, Dd, Dd, Dd, Dd, Dd, Dd, Dd, Dd, Dd, Dd, Hd, Dd, Dd, Dd, Hd, Hd, Hd, Hd, Hd, Hhd, Hhd, Hhd, Hhd, Hhd, Hd, Hhd, Hd, Hd, Dd, Dd, Dd, Dd, Dd, Dd, Dd^Edp, Hd, Hd
Hhd, Hhd, Hhd, Hhd, Hhd, Hhd, Hhd, Md, Md, Hhd, Hhd, Hhd, Hhd, Hd, Hhd, Hd, Hhd, Dd, Dd, Dd, Dd, Dd, Dd, Dd, Dd, Dd, Dd, Dd, Dd, Dd, Dd, Dd, Dd, Dd^Edp, Dd, Dd, Dd, Dd, Dd, Dd^Edp, Hd, Hd, Hd, Hhd, Hhd, Ce, Ke, Ce, Hhd, Hhd, Hd, Hd, Hd, Dd^Vdt, Dd, Dd^Edp, Dd, Hd, Hd, Dd, Dd, Dd
Hhd, Hhd, Hhd, Hhd, Hhd, Hhd, Hhd, Md, Md, Md, Md, Hhd, Hhd, Hhd, Hhd, Hhd, Hd, Hhd, Dd, Dd, Dd, Dd, Dd, Dd, Dd, Dd, Dd, Dd, Dd, Dd, Dd, Dd, Dd, Dd, Dd, Dd, Dd, Hd, Hd, Dd, Hd, Hd, Hd, Hhd, Hhd, Ce, Ce^Es, Ce, Hhd, Hhd, Hd, Hd, Dd, Hd, Dd^Edp, Dd, Dd, Hd, Hd, Dd, Dd, Dd
Dd, Hd, Hd, Hhd, Hd, Hhd, Hhd, Md, Md, Md, Md, Md, Hhd, Hhd, Hhd, Hhd, Hd, Hd, Dd, Dd, Dd, Dd, Dd, Dd, Dd, Dd, Hd, Dd, Dd, Dd, Dd, Dd, Dd, Dd, Dd^Edp, Dd, Dd, Dd, Dd^Edp, Dd, Hd, Hd, Hd^Vdt, Hd, Hhd, Hhd, Hhd, Hhd, Hd, Hd, Hd, Hd, Dd^Vdt, Wwt, Wwt, Dd, Dd, Dd, Dd, Dd, Hd, Hd
Dd, Dd, Dd, Hd, Hhd, Hd, Hhd, Hhd, Hhd, Md, Hhd, Md, Hhd, Hhd, Hhd, Hd, Hhd, Hd, Dd, Dd, Dd, Dd, Dd, Hd, Hd, Hd, Hd, Hd, Hd, Dd, Dd, Dd, Dd, Dd, Dd, Dd, Dd, Dd, Dd, Dd, Hd, Hd, Hd, Hd, Hd, Hd, Hd, Hd, Hd, Hd^Edp, Hd, Dd, Dd, Wwt, Wwt, Dd^Ftd, Dd, Dd, Dd, Dd, Dd, Dd
Dd, Dd, Dd, Hhd, Hhd, Hhd, Hhd, Hhd, Hhd, Hhd, Hhd, Hhd, Hhd, Hhd, Hd, Hhd, Hd, Dd, Dd, Dd, Dd, Dd, Dd^Edp, Hd, Hd, Hd, Dd^Vdt, Hd, Dd, Dd, Dd, Dd, Dd, Dd, Dd, Dd, Dd, Dd, Dd, Hd, Hd, Dd, Dd, Hd, Hd, Hd, Hd, Dd, Dd^Vdt, Dd, Hd, Dd, Dd^Edp, Dd, Dd, Dd, Dd, Hd, Dd, Dd^Edp, Dd, Dd
Dd, Dd, Dd, Hd, Hd, Hhd, Hhd, Hhd, Dd, Hhd, Dd, Hd, Hd, Hd, Hd, Hd, Hd, Hd, Dd, Dd, Dd, Dd, Dd, Dd, Hd, Hd, Hd, Hd, Dd, Dd, Dd, Dd, Dd, Dd, Dd, Dd, Dd^Edp, Dd, Dd, Dd, Dd, Dd, Dd, Dd^Vdt, Dd, Dd, Dd, Dd, Dd, Dd, Dd, Hd, Dd, Dd, Dd, Dd, Hd, Dd, Dd, Hd, Dd, Dd
Dd, Dd, Dd, Hd, Hhd, Hhd, Hhd, Hd, Hd, Dd, Dd, Dd, Hd, Hd, Hd, Dd, Dd, Dd, Dd, Dd, Dd, Dd, Dd, Dd, Hd, Hd, Dd, Dd, Dd, Dd, Dd, Dd, Dd, Dd, Dd, Dd, Dd, Dd, Hd, Dd, Dd, Dd^Edp, Dd, Dd, Dd, Dd, Dd^Vdt, Dd, Hd, Dd, Dd, Dd, Dd, Dd^Vdt, Dd, Dd, Dd, Dd, Dd, Dd, Dd, Dd
Dd, Dd, Dd, Hd, Hd, Hd, Hd, Hd, Dd, Dd, Dd, Dd, Dd, Hd, Hd, Hd, Dd, Dd^Vdt, Dd, Dd, Dd, Dd, Dd, Dd, Dd, Dd, Dd, Dd, Dd, Dd, Dd, Dd^Edp, Dd, Dd, Dd, Dd, Dd, Dd, Dd, Dd, Dd, Hd, Dd, Dd, Dd, Dd, Dd, Dd, Dd, Dd, Dd, Dd, Dd, Dd, Dd, Dd, Dd, Dd, Hd, Dd, Dd, Dd
Dd, Dd, Dd, Dd, Dd, Dd, Dd, Dd, Dd, Dd, Dd^Edp, Dd, Hd, Hd, Hd, Hd, Dd, Dd, Dd, Dd, Dd, Dd, Dd, Dd, Dd, Dd, Dd, Dd, Dd, Dd, Dd, Dd, Dd, Dd, Dd, Dd, Dd, Dd, Dd, Dd, Dd, Dd, Hd, Hd, Hd, Dd, Dd, Dd, Hd, Dd^Vdt, Hd, Dd, Dd, Hd, Dd, Dd, Hd, Dd, Dd, Dd, Dd, Dd
Dd, Dd, Dd, Dd, Dd, Dd, Dd, Dd, Dd, Dd, Dd, Dd, Hd, Hd, Hd, Hd, Dd, Dd, Dd, Dd, Dd, Dd, Dd, Dd, Dd, Dd, Dd, Dd, Dd, Dd, Dd, Dd, Dd, Dd, Dd, Dd, Dd, Dd, Dd, Dd, Dd, Dd, Hd, Hd, Dd, Dd, Dd, Dd, Dd, Hd, Dd, Dd, Dd, Dd, Hd, Hd, Hd, Hd, Dd, Dd, Dd, Dd
Dd, Dd, Dd, Dd, Dd, Dd^Edp, Dd, Dd, Dd, Dd, Dd, Dd, Dd, Hd, Hd, Hd, Dd, Dd, Dd, Dd, Dd, Dd, Dd, Dd, Dd, Dd, Dd, Dd, Dd, Dd, Dd, Dd, Dd, Dd, Dd, Dd, Dd, Dd, Dd, Dd, Dd, Dd, Dd, Dd, Dd, Hd, Dd, Dd, Hd, Dd, Dd, Dd, Dd, Dd, Hd, Hd, Dd, Dd, Dd, Dd, Dd, Dd
Dd, Dd, Dd, Dd, Dd, Dd, Dd, Dd, Dd, Dd, Dd, Dd, Dd, Dd, Dd, Dd, Dd, Dd, Dd, Dd, Dd, Dd, Dd, Dd, Dd, Dd, Dd, Dd, Dd, Dd, Dd, Dd, Dd, Dd, Dd, Dd, Dd, Dd, Dd, Dd, Dd, Dd, Dd, Dd, Dd, Dd, Dd, Dd, Dd, Dd, Dd, Hd, Dd, Dd, Dd, Hd, Dd, Dd, Dd, Dd, Dd, Dd
Dd, Dd, Dd, Dd, Dd, Dd, Dd, Dd, Dd, Dd, Dd, Dd, Dd, Dd, Dd, Dd, Dd, Dd, Dd, Dd, Dd, Dd, Dd, Dd, Dd, Dd, Dd, Dd, Dd, Dd, Dd, Dd, Dd, Dd, Dd, Dd, Dd, Dd, Dd, Dd, Dd, Dd, Dd, Dd, Dd, Dd, Dd, Dd, Dd, Dd, Dd, Dd, Dd, Dd, Dd, Dd, Dd, Dd, Dd, Dd, Dd, Dd
Dd, Dd, Dd, Dd, Dd, Dd, Dd, Dd, Dd, Dd, Dd, Dd, Dd, Dd, Dd, Dd, Dd, Dd, Dd, Dd, Dd, Dd, Dd, Dd, Dd^Dc, Dd, Dd, Dd, Dd, Dd, Dd, Dd, Dd, Dd, Dd, Dd, Dd, Dd^Dc, Dd, Dd, Dd, Dd, Dd, Dd, Dd, Dd, Dd, Dd, Dd, Dd, Dd, Dd, Dd, Dd, Dd, Dd, Dd, Dd, Dd, Dd, Dd, Dd
Dd, Dd, Dd, Dd, Dd, Dd, Dd, Dd, Dd, Dd, Dd, Dd, Dd, Dd, Dd, Dd, Dd, Dd, Dd, Dd, Dd, Dd, Dd, Dd, Dd, Dd, Dd, Dd, Dd, Dd^Dc, Dd, Dd, Dd, Dd^Dc, Dd, Dd, Dd, Dd, Dd, Dd, Dd^Dc, Dd, Dd, Dd, Dd^Dc, Dd, Dd, Dd, Dd, Dd, Dd, Dd, Dd, Dd, Dd, Dd, Dd, Dd, Dd, Dd, Dd, Dd
Dd, Dd, Dd, Dd, Dd, Dd, Dd, Dd, Dd, Dd, Hd, Dd, Dd, Dd, Dd, Dd^Edp, Dd, Dd, Dd, Dd^Dc, Dd, Dd, Dd, Dd^Edp, Dd, Dd, Dd, Dd, Dd, Dd, Dd, Dd, Dd, Dd, Dd, Dd, Dd^Dc, Dd, Dd, Dd, Dd, Dd, Dd, Dd, Dd, Dd, Dd, Dd, Dd, Dd, Dd, Dd, Dd, Dd, Dd, Dd, Dd, Dd, Dd, Dd, Dd, Dd
Dd, Dd, Dd, Dd^Edp, Dd, Dd, Dd, Dd, Dd, Hd, Hd, Dd, Dd, Dd, Dd, Dd, Dd, Dd, Dd, Dd, Dd, Dd, Dd^Dc, Dd, Dd, Dd, Dd^Dr, Dd, Dd^Dc, Dd^Es, Dd, Dd, Dd, Rd, Dd, Dd, Dd^Es, Dd, Dd^Dr, Dd^Es, Dd, Dd, Dd, Dd, Dd, Dd, Dd, Dd, Dd, Dd, Dd, Dd, Dd, Dd, Dd, Dd, Dd, Dd, Dd, Dd, Hd, Hd
Dd, Dd, Dd, Dd, Dd, Dd, Dd, Dd, Hd, Hd, Hd, Dd, Dd, Dd, Dd, Dd, Dd, Dd, Dd^Dc, Dd, Dd, Dd, Dd^Es, Dd, Dd^Dr, Dd^Dc, Cdr, Cdr, Dd^Es, Dd^Dr, Cdr, Dd^Es, Dd^Dr, Rd^Es, Dd^Es, Dd^Es, Cdr, Cdr, Cdr, Dd^Dr, Dd^Dc, Dd, Dd, Dd^Dc, Dd, Dd, Dd^Dc, Dd, Dd, Dd, Dd, Dd, Dd, Dd, Dd, Dd, Hd, Hd, Hd, Hd, Hd, Hd
Dd, Dd, Dd, Dd, Dd, Dd, Dd, Dd, Dd, Hd, Dd, Dd, Dd, Dd, Dd^Dc, Dd, Dd, Dd, Dd, Dd, Dd, Dd, Dd, Dd, Cdr, Dd^Dr, Dd^Es, Dd^Es, Dd^Dc, Ds, Ds, Dd^Dc, Cdr, Rd, Cdr, Dd^Dr, Dd^Dc, Ds^Es, Ds^Es, Dd^Dr, Dd^Dc, Dd, Dd^Dr, Dd, Dd, Dd, Dd, Dd, Dd, Dd, Dd^Dc, Dd, Dd, Dd, Dd, Dd, Dd, Hd, Hd, Hd, Hd, Hd
Dd, Dd, Dd, Dd, Dd, Dd, Dd, Dd, Dd, Dd, Dd, Dd, Dd, Dd, Dd, Dd, Dd, Dd, Dd, Dd, Dd, Dd^Dr, Dd^Dr, Dd^Dc, Re^Es, Ds, 1 Dd^Dr, Dd^Es, Rd, Rd, Rd, Ds^Es, Re^Es, Rd, Re^Es, Ds^Es, Cdr, Cdr, Dd^Dr, Ds^Es, Ds, Cdr, Dd^Dr, Dd^Dc, Dd^Es, Dd^Es, Dd, Dd, Dd, Dd, Dd, Dd, Dd, Dd, Dd, Dd, Dd, Dd, Dd, Hd, Dd, Dd
Dd, Dd, Dd, Dd, Dd, Dd, Dd, Dd, Dd, Dd, Dd, Dd, Dd, Dd, Dd, Dd, Dd^Es, Dd^Dc, Dd^Es, Dd, Cdr, Dd^Dc, Dd^Es, Re, Dd^Dc, Re, Rd, Re, Re^Es, Re^Es, Dd^Dr, Re, Rd, Rr, Rr^Es, Rr, Cdr, Dd^Dc, Dd^Dr, Dd, Gd, Ds^Es, Gd, Cdr, Dd^Dr, Dd, Dd, Dd, Dd, Dd, Dd, Dd, Dd, Dd, Dd, Dd, Dd, Dd, Dd, Dd, Dd, Dd
Dd, Dd, Dd, Dd, Dd, Dd, Dd, Dd, Dd, Dd, Dd, Dd, Dd, Dd^Dc, Dd, Dd, Dd^Es, Dd, Cdr, Cdr, Dd^Dr, Dd, Dd^Vda, Re, Rd, Rd, Ds^Es, Dd^Dr, Ds, Dd, Ds^Edp, Dd^Dc, Ds^Ft, Rd, Dd^Es, Rd, Dd^Dr, Cdr, Re^Es, Dd^Dr, Dd^Dc, Gs^Es, Gs^Es, Gd, Dd^Dc, Dd^Dr, Dd, Dd, Dd^Dc, Dd, Dd, Dd, Dd, Dd, Dd, Dd, Dd, Dd, Dd, Dd, Dd, Dd
Dd, Dd, Dd, Dd, Dd, Dd, Dd, Dd, Dd, Dd, Dd, Dd, Dd, Dd, Dd, Dd, Dd, Cdr, Ds^Es, Dd^Dc, Dd^Dr, Re, Rd, Rd, Re, Dd^Es, Ds, Dd^Ftd, Wot, Wot, Wot, Wot, Wot, Ds^Ftd, Wot, Dd^Es, Ds^Ftd, Dd^Es, Dd^Es, Re, Ds, Gd, Gs, Gd^Es, Dd^Dr, Dd^Dc, Dd, Dd, Dd, Dd, Dd, Dd^Dc, Dd, Dd, Dd, Dd, Dd, Dd, Dd, Dd, Dd, Dd
Dd, Dd, Dd, Dd, Dd, Dd, Dd, Dd, Dd, Dd^Dc, Dd, Dd, Dd, Dd, Dd, Dd^Es, Dd, Cdr, Dd^Dr, Ds^Es, Re, Re, Rr, Re^Es, Re, Dd^Vda, Ds^Ftd, Wot, Wot, Wot, Wwt, Wwt, Wwt, Wot, Wot, Wot, Wwt, Wot, Wwrt, Wwt^Bw|, Wwt, Ds, Gs^Es, Gs^Es, Cdr, Dd^Es, Dd, Dd^Edp, Dd, Dd, Dd, Dd, Dd, Dd, Dd, Dd, Dd, Dd, Dd, Dd, Dd, Dd
Dd, Dd, Dd, Dd, Dd, Dd, Dd, Dd, Dd, Dd, Dd, Dd, Dd^Dc, Dd, Dd^Es, Dd^Dc, Dd^Es, Cdr, Ds^Es, Dd^Dc, Ds^Es, Rd^Es, Rr, Dd^Dc, Re, Ds, Wwt, Wot, Wot, Wwt, Gs, Gd, Gs, Wwt, Wot, Wwt, Wwf, Wwt, Wwt, Gs, Gs, Dd^Dc, Gs^Es, Gd, Dd^Dc, Dd, Dd^Dc, Dd, Dd, Dd, Dd, Dd, Dd, Dd, Dd, Dd, Dd, Dd, Dd, Dd, Dd, Dd
Dd, Dd, Dd, Dd, Dd, Dd, Dd, Dd, Dd, Dd, Dd, Dd, Dd, Dd, Dd, Dd, Dd^Es, Cdr, Dd^Es, Dd, Dd^Dc, Rd, Re, Re, Dd^Dc, Ds^Ftd, Wwt, Wwf, Wot, Wwt, Gd, Dd^Dr, Gs^Es, Wwt, Wot, Wwt, Wot, Wwt, Gd^Ft, Gs^Es, Ww^Bw|, Wwt, Gs^Es, Gd, Dd^Dr, Dd^Dr, Dd, Dd, Dd, Dd^Dc, Dd, Dd, Dd, Dd, Dd, Dd, Dd, Dd, Dd, Dd, Dd, Dd
Dd, Dd, Dd, Dd, Dd, Dd, Dd, Dd, Dd, Dd^Dc, Dd, Dd, Dd, Dd, Dd, Dd^Es, Dd^Dc, Cdr, Dd^Es, Dd^Dr, Rd, Re, Re^Es, Dd^Dr, Dd, Ds^Ftd, Wot, Wot, Wot, Wwt, Wwt, Gs, Wwt, Wwt, Wot, Wot, Wwt, Wwt, Wwt, Wwrt, Re^Es, Gg, Gg, Gd^Vc, Cdr, Dd^Es, Dd^Es, Dd^Es, Dd, Dd, Dd, Dd, Dd, Dd, Dd, Dd, Dd, Dd, Dd, Dd, Dd, Dd
Dd, Dd, Dd, Dd, Dd, Dd, Dd, Dd, Dd, Dd, Dd, Dd, Dd, Dd, Dd, Dd, Dd^Dr, Dd^Dr, Ds, Ds, Re, Rd, Re, Dd, Ds, Ds, Wwrt, Wot, Wot, Wot, Wwt, Wwt^Bw|r, Wot, Wot, Wwt, Wwf, Wwt, Wwf, Wwt, Re, Gs, Gs, Dd^Dc, Gs^Es, Cdr, Dd, Dd, Dd, Dd, Dd, Dd, Dd, Dd, Dd, Dd, Dd, Dd, Dd, Dd, Dd, Dd, Dd
Dd, Dd, Dd, Dd, Dd, Dd, Dd, Dd, Dd, Dd, Dd, Dd, Dd, Dd^Dc, Dd, Dd, Dd^Es, Cdr, Ds^Es, Dd^Dr, Re, Re^Dr, Re, Dd^Vda, Ds, Ds, Dd^Dr, Wwf, Wwt, Wot, Wot, Wwt, Wwt, Wot, Wot, Wwt, Re^Es, Dd^Dc, Gs^Ft, Ww^Bw|, Wwt, Wwt, Gs, Gs^Es, Cdr, Dd^Es, Dd, Dd^Dc, Dd, Dd, Dd, Dd^Dc, Dd, Dd, Dd, Dd, Dd, Dd, Dd, Dd, Dd, Dd
Dd, Dd, Dd, Dd, Dd, Dd, Dd, Dd, Dd, Dd, Dd, Dd, Dd, Dd, Dd, Dd^Es, Dd^Es, Cdr, Ds, Ds, Re, Rd, Rd, Dd, Dd^Dr, Dd^Dc, Ds^Ftd, Wwt, Wwt, Wwf, Wwt, Ww^Bw|r, Wwt, Wot, Ds, Ds^Ftd, Re, Ds, Rr, Rr, Ds, Ds^Es, Gd, Gs^Vc, Cdr, Dd^Es, Dd^Es, Dd, Dd, Dd, Dd, Dd, Dd, Dd, Dd, Dd, Dd, Dd, Dd, Dd, Dd, Dd
Dd, Dd, Dd, Dd, Dd, Dd, Dd, Dd, Dd, Dd^Dc, Dd, Dd, Dd, Dd, Dd^Dc, Dd, Dd, Cdr, Ds^Es, Dd^Dr, Rd, Rd^Es, Rd, Re^Es, Dd^Dc, Dd, Dd^Vda, Ds, Ds, Ds^Ftd, Wwt, Wwt^Bw|r, Wwt, Ds^Edp, Rd, Rd, Rd, Re^Es, Re, Dd^Dr, Re^Es, Ds, Dd^Dc, Gd^Es, Cdr, Dd, Dd^Dc, Dd, Dd, Dd, Dd, Dd, Dd, Dd, Dd, Dd, Dd, Dd, Dd, Dd, Dd, Dd
Dd, Dd, Dd, Dd, Dd, Dd, Dd, Dd, Dd, Dd, Dd, Dd, Dd, Dd, Dd, Dd, Dd^Es, Cdr, Ds^Es, Ds, Dd^Es, Re, Re^Es, Rr, Rr, Rd, Ds, Dd, Dd^Dc, Dd^Es, Rd, Rd, Re, Re, Rd^Es, Rd, Dd^Vda, Rd, Re, Dd^Dc, Re, Ds, Dd^Dr, Dd^Dr, Dd, Dd, Dd^Es, Dd, Dd, Dd, Dd^Dc, Dd, Dd, Dd, Dd, Dd, Dd, Dd, Dd, Dd, Dd, Dd
Dd, Dd, Dd, Dd, Dd, Dd, Dd, Dd, Dd, Dd, Dd, Dd, Dd, Dd, Dd^Es, Dd, Dd^Es, Cdr, Dd^Dr, Dd^Dc, Dd^Dr, Dd^Es, Dd^Dc, Re, Rd^Dr, Rd, Rd, Dd^Dr, Rd^Es, Rd, Rr, Rr, Ds^Es, Re, Re, Rd, Rd^Dr, Rd, Re, Re^Es, Cdr, Cdr, Dd^Es, Dd, Dd^Dc, Dd, Dd, Dd, Dd, Dd, Dd, Dd, Dd, Dd, Dd, Dd, Dd, Dd^Vdt, Dd, Dd, Dd, Dd
Dd, Dd, Dd, Dd, Dd, Dd, Dd, Dd, Dd, Dd, Dd^Dc, Dd, Dd, Dd, Dd, Dd, Dd, Dd^Es, Dd^Dc, Dd^Dr, Cdr, Ds^Es, Dd^Dr, Rd, Dd^Dc, Re, Rd, Rd, Rd^Es, Rd^Es, Rd, Rd, Dd, Dd^Es, Cdr, Re, Dd^Es, Dd^Dc, Cdr, Cdr, Dd, Dd^Es, Dd, Dd, Dd, Dd, Dd^Edp, Dd, Dd, Dd, Dd, Dd, Dd, Dd, Dd, Dd, Dd, Dd, Dd, Dd, Dd, Dd
Dd, Dd, Dd, Dd, Dd, Dd, Dd, Dd, Dd, Dd, Dd, Dd, Dd, Dd, Dd, Dd^Dc, Dd, Dd, Dd, Dd, Dd, Cdr, Cdr, Ds^Es, Ds^Es, Ds, Dd^Es, Rd, Ds, Rd, Ds^Es, Dd^Dr, Dd^Dc, Dd^Dr, Dd^Es, Cdr, Dd^Dc, Dd^Dr, Dd^Es, Dd, Dd^Dc, Dd^Es, Dd, Dd, Dd, Dd, Dd^Dc, Dd, Dd, Dd, Dd, Dd, Dd, Dd, Dd, Dd, Dd, Dd, Dd, Dd, Dd, Dd
Dd, Dd, Dd, Dd, Dd, Dd, Dd, Dd, Dd, Dd, Dd, Dd, Dd, Dd, Dd, Dd, Dd, Dd, Dd^Es, Dd, Dd, Dd^Es, Dd, Cdr, Cdr, Dd^Dr, Dd^Dc, Ds^Es, Dd^Dr, Dd^Dc, Cdr, Dd^Dr, Dd, Dd, Dd^Es, Dd, Dd^Es, Dd, Dd, Dd, Dd, Dd, Dd, Dd, Dd, Dd, Dd, Dd, Dd, Dd, Dd, Dd, Dd, Dd, Dd, Dd, Dd, Dd, Dd, Dd, Dd, Dd
Dd, Dd, Dd, Dd, Dd, Dd, Dd, Dd, Dd, Dd, Dd, Dd, Dd, Dd, Dd, Dd, Dd, Dd, Dd, Dd, Dd^Dc, Dd^Es, Dd^Es, Dd, Dd, Cdr, Cdr, Ds, Cdr, Cdr, Dd^Es, Dd^Es, Dd^Es, Dd, Dd^Dc, Dd, Dd, Dd, Dd^Dc, Dd, Dd, Dd, Dd^Dc, Dd, Dd, Dd, Dd, Dd, Dd, Dd, Dd, Dd, Dd, Dd^Edp, Dd, Dd, Dd, Dd, Dd, Dd, Dd, Dd
Dd, Dd, Dd, Dd, Dd, Dd, Dd, Dd, Dd, Dd, Dd, Dd, Dd, Dd^Dc, Dd, Dd, Dd, Dd, Dd, Dd, Dd, Dd, Dd, Dd^Es, Dd^Dc, Dd, Dd, Cdr, Dd, Dd, Dd^Dc, Dd, Dd, Dd, Dd, Dd, Dd, Dd, Dd, Dd, Dd, Dd, Dd, Dd, Dd, Dd, Dd, Dd, Dd, Dd, Dd, Dd, Dd, Dd, Hd, Dd, Hd, Dd, Dd, Dd, Dd, Dd
Dd, Dd, Dd, Dd, Dd, Dd, Dd, Dd, Dd, Dd, Dd, Dd, Dd, Dd, Dd, Dd, Dd, Dd, Dd, Dd, Dd, Dd, Dd, Dd, Dd, Dd, Dd, Dd^Es, Dd, Dd^Es, Dd, Dd, Dd, Dd, Dd, Dd, Dd, Dd, Dd^Dc, Dd, Dd, Dd, Dd, Dd, Dd, Dd, Dd, Dd, Dd, Dd, Dd, Dd, Dd, Dd, Hd, Hhd, Hhd, Hd, Hd, Dd, Dd, Dd
Dd, Dd, Dd, Dd, Dd, Dd, Dd, Dd, Dd, Dd, Dd, Dd, Dd, Dd, Dd, Dd, Dd, Dd^Dc, Dd, Dd, Dd, Dd, Dd, Dd, Dd, Dd, Dd, Dd, Dd, Dd, Dd, Dd, Dd, Dd, Dd, Dd^Dc, Dd, Dd, Dd, Dd, Dd, Dd, Dd, Dd, Dd, Dd, Dd, Dd, Dd, Dd, Dd, Dd, Dd, Dd, Hd, Hd, Hhd, Hd, Hd, Dd, Dd, Dd
Dd, Dd, Dd, Dd, Dd, Dd, Dd, Dd, Dd, Dd, Dd, Dd, Dd, Dd, Dd, Dd, Dd, Dd, Dd, Dd, Dd, Dd^Dc, Dd, Dd, Dd, Dd, Dd, Dd^Dc, Dd, Dd, Dd, Dd^Dc, Dd, Dd, Dd, Dd, Dd, Dd, Dd, Dd, Dd, Dd, Dd, Dd, Dd, Dd, Dd, Dd, Dd, Dd, Dd, Dd^Vdt, Dd, Hd, Hd, Hhd, Hhd, Hhd, Hhd, Hd, Dd, Dd
Dd, Dd, Dd, Dd, Dd, Dd, Dd, Dd, Dd, Dd, Dd, Dd, Dd, Dd, Dd, Dd, Dd, Dd, Dd, Dd, Dd, Dd, Dd, Dd, Dd, Dd, Dd, Dd, Dd, Dd, Dd, Dd, Dd, Dd, Dd, Dd, Dd, Dd, Dd, Dd, Dd, Dd, Dd, Dd, Dd, Dd, Dd, Dd, Hd, Hd, Hd, Dd, Hhd, Hd, Hhd, Hhd, Hhd, Hhd, Hd, Dd, Dd, Dd
Dd, Dd, Dd, Dd, Dd, Dd, Dd, Dd, Dd, Dd, Dd, Dd, Dd, Dd, Dd, Dd, Dd, Dd, Dd, Dd, Dd, Dd, Dd, Dd, Dd, Dd, Dd, Dd, Dd, Dd, Dd, Dd, Dd, Dd, Dd, Dd, Dd, Dd, Dd, Dd, Dd, Dd^Edp, Dd, Dd, Dd, Dd, Dd, Dd, Hhd, Hhd, Hhd, Hhd, Hd, Hhd, Hd, Hd, Hd, Dd, Dd, Dd, Dd, Dd
Dd, Dd, Dd, Dd, Dd, Dd, Dd, Dd, Dd, Dd, Dd, Dd, Dd, Dd, Dd, Dd, Dd, Dd, Dd, Dd, Dd, Dd, Dd, Dd, Dd, Dd, Dd, Dd, Dd, Dd, Dd, Dd, Dd, Dd, Dd, Dd, Dd, Dd, Dd, Dd, Dd, Dd, Dd, Dd, Dd, Dd, Dd, Hd, Dd, Hd, Hd, Hd, Dd, Dd, Dd, Dd, Dd, Dd, Dd, Dd, Dd, Dd
