border_size=1
usage=map

Dd, Dd, Dd, Dd, Dd, Dd, Dd, Dd, Dd, Dd, Dd, Dd, Dd, Dd, Dd, Dd, Dd, Dd, Dd, Dd, Dd, Dd, Dd, Dd, Dd, Dd, Dd, Dd, Dd, Dd, Dd, Dd, Dd, Dd, Dd, Dd, Dd, Dd, Dd, Dd, Dd
Dd, Dd, Dd, Dd, Dd, Dd, Dd^Es, Dd, Dd, Dd, Dd, Dd, Dd, Dd, Dd, Dd, Dd, Dd, Dd, Dd, Dd, Dd, Dd, Dd, Dd, Dd, Dd, Dd, Dd, Dd^Es, Dd, Dd, Dd, Dd, Dd, Dd, Dd, Dd, Dd, Dd, Dd
Dd, Dd, Dd, Dd, Hd, Dd, Dd, Dd, Dd^Esd, Dd, Dd, Dd, Hd, Dd, Dd, Dd, Dd, Dd, Dd, Hd, Dd, Dd, Hd, Hd, Dd, Dd, Dd, Dd, Hd, Dd, Dd, Dd, Hd, Dd, Dd, Dd, Hd, Hd, Dd, Dd, Dd
Dd, Dd, Dd, Dd, Dd^Edp, Hd, Hd, Dd, Dd, Dd, Dd, Dd, Dd, Dd, Dd, Hd, Hd, Dd, Hhd, Dd, Hhd, Hhd, Hhd, Dd, Hd, Dd, Hd, Dd, Hd, Hd, Dd, Dd, Dd, Dd^Esd, Dd, Hd, Hd, Hd, Dd, Dd, Dd
Dd, Dd, Dd, Dd, Dd, Hd, Hd, Dd, Dd, Hd, Hd, Dd, Dd, Dd, Dd, Dd, Hd, Dd, Hhd, Hhd, Ce, Ce, Ce, Hhd, Hhd, Hd, Hd, Hd, Hd, Hd, Dd, Dd, Dd, Dd, Dd, Dd, Dd, Dd, Dd, Dd, Dd
Dd, Dd, Hd, Hd, Dd, Dd, Dd, Dd, Dd, Hd, Dd, Dd, Dd, Hd, Dd, Hd, Hhd, Hhd, Hhd, Hhd, Ce, Wwg, Wwg, Ce, Hhd, Hhd, Hhd, Hd, Hd, Hd, Hd, Hd, Dd, Dd, Hd, Dd, Dd, Hd, Dd, Dd, Dd
Dd, Dd, Dd, Hd, Dd, Dd^Esd, Dd, Dd, Dd, Dd, Dd, Dd, Dd, Dd, Dd, Hd, Hhd, Hhd, Md, Hhd, Ce, Ce, 2 Ke, Ce, Hhd, Hhd^Ecf, Hhd, Hhd, Hhd, Hd, Hd, Dd^Edp, Dd, Dd, Dd, Dd, Dd, Dd, Dd, Dd, Dd
Ds, Dd, Dd, Hd, Dd, Dd, Hd, Dd, Dd, Dd^Edp, Dd, Dd, Dd, Dd, Hd, Hhd, Hhd, Hhd^Vdt, Md, Hhd, Hhd, Ce, Ce, Ce, Hhd, Hhd, Hhd, Hhd^Vdt, Hd, Hd, Hd, Dd, Hd, Dd, Dd, Dd, Dd, Dd, Hd, Dd, Dd
Ds, Dd, Dd, Dd, Dd, Hd, Hd, Dd, Dd, Dd, Dd, Hd, Hd, Dd, Hd, Hd, Hhd, Md, Md, Md, Md, Md, Md, Hhd, Md, Hhd, Hhd, Hhd, Hd, Dd, Hd, Hd, Dd, Dd, Hd, Dd, Dd, Hd, Hd, Dd, Dd
Ds, Ds, Ds, Dd, Dd, Hd, Dd, Hd, Dd, Dd, Ds, Dd, Dd, Dd, Hd, Hd, Hd, Md, Hhd, Md, Md, Md, Md, Md, Md, Md, Hhd, Hd, Hd, Hd, Hd, Dd, Dd, Dd, Dd, Hd, Dd, Dd, Dd, Dd, Dd
Dd, Ds, Ds, Ds, Dd, Dd^Esd, Dd, Dd, Ds, Ds, Ds^Edp, Ds, Dd, Dd, Dd, Hd, Hd, Hhd, Hhd, Hhd^Vdt, Md, Md, Md, Md, Hhd^Vdt, Hhd, Hhd, Hhd, Dd, Dd, Hd, Hd, Dd, Dd, Dd, Dd, Dd, Dd, Dd, Dd, Dd
Dd, Dd, Hd, Dd, Dd, Dd, Dd, Dd, Hd, Ds, Dd, Dd, Hd, Dd, Dd, Dd, Hd, Hd, Hhd, Hhd, Hhd, Md, Hhd, Md, Hhd, Hhd, Hhd, Hhd, Dd, Dd, Dd, Dd, Dd, Dd, Hd, Dd, Dd, Dd^Esd, Dd, Dd, Dd
Dd, Dd, Dd, Hd, Dd, Dd, Dd, Hd, Dd, Dd, Dd, Dd, Hd, Dd, Dd, Dd, Dd, Hd, Dd, Hhd, Hhd, Hhd, Hd, Hhd, Hhd, Dd, Dd, Dd, Dd, Dd, Dd, Dd, Dd^Es, Dd, Dd, Hd, Dd, Dd, Dd, Dd, Dd
Dd, Dd, Dd, Dd, Dd, Dd, Dd^Esd, Dd, Dd, Dd, Rd, Dd, Dd^Edp, Dd, Dd, Hd, Hd, Dd, Dd^Esd, Dd, Hd, Hd, Dd, Hd, Hhd, Hhd, Dd, Dd, Dd, Hd, Dd, Dd, Dd, Dd, Dd, Dd, Dd, Hd, Hd, Dd, Dd
Dd, Dd, Dd, Dd, Dd, Dd, Hd, Dd, Dd^Edp, Rd, Wwt, Dd, Dd, Dd, Dd, Dd, Dd, Dd, Dd, Dd, Dd, Dd, Dd, Dd, Dd, Hhd, Dd, Dd, Dd, Dd, Dd, Dd, Hd, Hd, Dd, Dd, Dd, Dd, Dd, Dd, Dd
Dd, Dd, Hd, Dd, Dd, Hd, Dd, Dd, Dd, Rd, Wwt, Wwt, Wwt, Rd, Rd, Dd, Dd^Edp, Dd, Hd, Hd, Dd, Dd, Hd, Dd, Dd, Dd, Dd, Dd, Hd, Dd, Dd, Dd^Esd, Dd, Hd, Dd, Dd, Dd, Dd, Dd, Dd, Dd
Dd, Dd, Hd, Hd, Dd, Dd, Dd, Dd, Dd, Dd^Edp, Gs^Ftd, Wwt, Wwt, Ds^Es, Ds, Ds, Dd, Dd, Dd, Dd, Dd^Es, Dd, Hd, Hd, Dd, Dd, Dd, Dd, Hd, Dd, Dd, Dd, Dd, Dd, Dd, Dd, Hd, Dd, Dd, Dd, Dd
Dd, Dd, Dd, Dd, Dd, Dd, Hd, Dd, Dd^Edp, Dd, Dd, Wwt, Dd, Ds^Edp, Ds, Dd^Esd, Dd, Dd, Rd, Dd, Dd, Dd, Dd, Hd, Dd, Dd, Dd, Dd, Dd, Dd, Dd, Dd, Dd, Dd, Dd, Hd, Ds, Hd, Dd, Dd, Dd
Dd, Dd, Dd, Dd, Dd, Hd, Dd, Dd, Dd, Dd, Dd, Dd, Dd, Dd, Dd, Hd, Dd, Dd, Rd, Dd, Dd, Dd, Dd^Esd, Dd, Dd, Dd, Dd, Dd, Dd, Dd, Dd, Dd, Dd, Dd, Ds, Ds, Ds^Esd, Dd, Dd, Dd, Dd
Dd, Dd, Dd, Dd, Dd, Dd, Dd, Dd, Dd, Dd, Hd, Dd, Dd, Dd, Dd, Ds, Ds, Dd, Dd, Rd, Dd, Dd, Dd, Dd, Dd, Dd^Es, Dd, Dd, Dd^Do, Dd, Dd, Dd, Dd, Dd, Dd, Dd, Ds, Dd, Dd, Dd, Dd
Dd, Dd, Hd, Dd, Dd, Dd, Dd, Dd, Dd, Dd, Dd, Dd, Dd, Hd, Dd, Dd, Ds, Dd, Dd, Dd, Dd, Dd, Rd, Dd, Dd, Dd, Dd, Dd, Dd, Dd, Dd, Dd, Dd^Es, Dd, Dd, Ds, Dd, Ds, Ds, Dd, Dd
Dd, Dd, Dd, Dd, Dd, Hd, Dd, Dd, Hd, Dd, Dd, Dd, Dd, Dd, Dd, Dd, Dd, Dd, Dd, Dd, Dd, Dd, Dd, Rd, Rd, Dd, Dd, Dd, Ds, Dd, Dd^Edp, Dd, Dd, Dd, Dd, Dd, Dd, Dd, Ds, Dd, Dd
Hhd, Ds, Hhd, Dd, Dd, Dd, Dd, Hd, Hd, Dd, Dd, Hd, Dd, Dd, Dd, Dd, Ds, Dd, Dd, Dd^Es, Dd, Dd, Dd, Dd, Dd, Dd, Dd, Ds, Ds, Dd, Dd, Dd, Dd, Dd, Dd, Dd, Dd, Dd, Dd, Dd, Dd
Hhd, Hhd, Hhd, Hhd, Dd, Dd, Dd, Hd, Dd, Dd, Hd, Dd, Dd, Dd, Ds, Ds, Ds, Dd, Dd, Dd, Dd, Dd, Dd, Dd, Dd, Dd, Dd^Esd, Dd, Dd, Ds, Dd, Dd, Dd, Dd^Es, Dd, Dd, Dd, Dd, Dd, Dd, Dd
Qxe, Hd, Hhd, Hhd, Hhd, Hhd, Dd, Dd, Dd, Dd, Dd^Es, Dd, Hd, Qxe, Ds, Ds, Ds, Dd, Dd, Dd, Dd, Dd, Dd, Dd, Dd, Dd, Dd, Dd, Dd, Rd, Rd, Dd, Dd^Es, Dd, Chr, Dd, Dd^Es, Dd, Dd, Ds, Dd
Hhd, Qxe, Qxe, Hhd, Hhd, Hd, Hd, Dd, Hd, Rd, Qxe, Dd, Rd, Qxe, Rd, Ds^Es, Dd, Dd, Dd, Dd, Hd, Dd, Hd, Dd, Hd, Dd, Dd, Dd, Dd, Dd, Dd^Es, Rd, Dd^Dr, Chr, 3 Khr, Chr^Es, Chr^Es, Dd, Dd^Es, Dd, Dd
Hhd, Hhd, Rd, Qxe, Rd^Es, Rd, Qxe, Hd, Qxe, Qxe, Hd, Qxe, Qxe, Qxe, Rd, Dd, Dd, Dd, Hd, Hd, Hd, Hd, Hd, Hd, Dd, Dd, Ds, Dd, Dd^Edp, Dd, Dd^Es, Dd^Dr, Chr, Dd^Dr, Chr^Es, Chr, Wwg, Chr, Dd, Dd, Dd
Hhd, Hhd, Hhd, Qxe, Qxe, Qxe, Dd, Qxe, Rd, Dd, Dd, Hd, Dd, Ds, Dd, Dd, Dd, Hd, Hd, Hd, Hd, Hd, Dd, Dd, Hd, Ds, Ds^Es, Ds, Dd, Dd, Dd^Es, Chr^Es, Rd^Es, Rd, Re, Wwg, Wwg, Chr^Es, Dd, Dd^Es, Dd
Hhd, Hhd, Hhd, Hd, Hd, Dd, Dd, Rd^Es, Dd, Dd, Dd, Dd, Ds, Ds, Dd, Dd, Dd, Hd, Hd, Hd, Hd, Dd, Dd, Hd, Hd, Dd, Ds, Ds, Dd, Dd, Dd^Es, Chr, Dd, Rd^Es, Rd^Es, Re^Es, Dd^Dr, Chr, Dd^Es, Dd^Es, Dd
Hhd, Hhd, Hhd, Hd, Hd, Dd, Dd, Dd, Dd, Dd, Dd, Hd, Ds, Ds, Ds, Dd, Dd, Hd, Hd, Hd, Hd, Dd, Dd, Dd, Dd, Dd, Dd, Dd, Rd, Dd^Es, Dd, Dd, Dd, Chr^Es, Chr, Dd^Dr, Dd, Dd^Es, Dd, Dd, Dd
Hd, Hhd, Hhd, Hhd, Hd, Hd, Dd, Dd^Es, Dd, Dd, Dd, Dd, Dd, Ds, Dd, Dd, Dd, Hd, Hd, Hd, Hd, Hd, Hd, Dd, Dd, Dd, Hd, Hd, Dd, Dd^Esd, Dd, Dd, Dd^Es, Dd, Dd, Dd^Es, Dd, Dd, Ds, Dd, Dd
Hd, Hd, Hd, Hd, Hd, Dd, Hd, Dd, Dd, Hd, Dd, Dd, Dd, Dd, Dd, Dd, Dd, Dd, Dd, Hd, Hd, Hd, Hd, Hd, Hd, Dd, Dd, Dd, Dd, Dd, Dd, Dd, Dd, Dd, Dd, Dd, Dd, Dd, Dd, Dd, Dd
Hd, Hd, Hd, Hd, Hd, Dd, Hd, Dd, Dd^Esd, Dd, Dd, Dd, Dd, Dd, Dd, Dd, Dd, Dd, Dd^Esd, Dd, Dd, Hd, Hd, Hd, Hd, Dd, Dd, Dd, Dd, Dd, Ds, Ds, Ds, Ds, Dd, Dd, Dd, Dd, Dd, Dd, Dd
Hd, Hd, Hd, Hd, Dd, Dd, Dd, Dd, Dd, Hd, Dd^Es, Dd, Hd, Dd, Dd, Dd, Dd^Do, Dd, Dd, Dd, Rd, Rd, Dd, Hd, Hd, Hd, Dd, Dd, Dd, Dd, Dd, Dd, Dd, Ds, Dd, Dd, Dd, Dd, Dd, Dd, Dd
Hd, Hd, Hd, Hd, Dd, Dd, Dd, Dd, Dd, Dd, Dd, Dd, Dd, Dd, Dd, Ds, Dd, Dd, Dd, Dd, Dd, Dd, Dd, Dd, Dd, Hd, Dd, Dd, Dd, Dd^Edp, Dd, Dd, Dd, Dd, Dd, Dd, Dd, Dd, Dd, Dd, Dd
Hd, Hd, Hd, Dd, Dd^Esd, Dd, Hd, Dd, Dd, Hd, Hd, Dd, Ds, Dd, Hd, Dd, Dd, Dd, Rd, Dd, Dd, Dd, Dd, Dd, Dd, Ds, Ds, Dd, Dd, Dd, Dd, Dd, Dd, Dd, Dd, Dd, Dd, Dd, Dd, Dd, Dd
Hd, Hd, Dd, Dd, Dd, Dd, Dd, Hd, Dd, Hd, Dd, Dd, Ds, Ds, Ds, Dd, Dd, Dd, Dd, Dd, Dd^Edp, Dd, Dd, Dd, Ds, Ds, Ds, Ds, Ds, Dd, Dd, Dd, Dd^Es, Dd, Dd, Dd, Dd, Dd, Dd, Dd, Dd
Dd, Dd, Dd, Dd, Dd, Dd^Edp, Dd, Dd, Dd, Dd, Dd, Hd, Dd, Dd, Dd, Dd, Dd, Rd, Dd, Dd, Dd, Dd, Dd, Dd, Dd, Dd, Dd, Ds, Ds, Ds, Dd, Dd, Dd, Dd, Dd, Dd, Hd, Dd, Dd, Dd, Dd
Hd, Hd, Hd, Dd, Dd, Dd, Dd, Dd, Hd, Dd, Dd^Edp, Dd, Dd, Dd, Dd^Esd, Dd, Dd, Rd, Dd, Dd, Dd, Dd, Dd, Dd^Esd, Dd, Dd, Dd, Dd, Dd, Dd, Dd, Dd, Dd, Dd, Hd, Hd, Dd, Dd, Dd, Dd, Dd
Hd, Hd, Dd, Hd, Dd^Edp, Dd, Hd, Dd, Dd, Dd, Dd, Dd, Dd, Dd, Dd, Dd, Dd, Dd, Dd, Dd, Dd, Dd, Dd, Dd, Dd, Dd, Dd^Esd, Dd, Dd, Dd, Dd, Dd, Hd, Hd, Hd, Hd, Dd, Dd, Dd, Dd, Dd
Dd, Dd, Dd^Edp, Dd, Dd, Dd, Hd, Hd, Dd, Dd, Hd, Dd, Rd, Rd, Dd, Dd, Dd^Edp, Dd, Dd, Dd, Dd, Dd, Dd, Ds, Ds^Esd, Ds, Dd, Dd, Dd, Dd, Hd, Hd, Hd, Hd, Dd, Dd, Dd, Dd, Ds, Dd, Dd
Dd, Dd, Dd, Hd, Hd, Dd, Dd, Hd, Dd, Dd, Dd^Edp, Dd, Dd, Dd, Dd, Dd, Dd, Dd, Dd, Dd, Dd, Dd, Dd, Dd, Ds, Dd, Dd, Dd, Dd, Hd, Hd, Hd, Hd, Hd, Dd, Dd, Dd, Ds, Ds^Edp, Dd, Ds
Ds, Ds, Ds, Hd, Dd, Dd, Dd^Edp, Dd, Gd^Edp, Dd, Rd, Rd, Dd, Dd^Ecf, Dd^Edp, Dd, Dd, Dd, Dd, Dd, Ds, Ds, Ds, Dd, Ds, Ds, Dd, Dd, Hd, Hd, Hd, Hd, Hd, Dd, Dd, Dd, Dd, Dd^Esd, Dd, Dd, Dd
Dd, Dd, Dd, Ds, Dd^Edp, Wwt, Wwt, Wwt, Wwt, Gs^Esd, Gs^Ftd, Dd, Hd, Dd, Dd, Dd, Ds, Ds, Dd, Dd^Edp, Dd, Dd, Dd, Ds, Dd, Dd, Dd, Dd, Hd, Hd, Hd, Hd, Hd, Dd, Dd, Dd^Edp, Dd, Dd, Dd, Dd, Dd
Dd, Dd, Hd, Dd, Dd, Wwt, Wwt, Wwt, Wwt, Wwf, Gs^Ftd, Dd, Hd, Dd, Dd, Dd, Dd^Es, Ds, Dd, Dd, Dd, Dd^Es, Dd, Dd, Dd, Dd, Dd, Dd, Hd, Hd, Hd, Hd, Hd, Dd, Dd, Dd, Hd, Hd, Dd, Dd, Dd
Hd, Hd, Hd, Dd, Dd^Edp, Dd, Wwt, Wwt, Gd^Edp, Gs, Rd, Dd, Dd, Dd, Hd, Dd, Dd, Dd, Dd, Dd, Dd, Dd, Dd, Dd, Dd, Dd, Dd, Hd, Hd, Hd, Hd, Hd, Hd, Dd, Dd, Dd, Hd, Dd, Dd, Dd, Dd
Hd, Hd, Dd, Dd, Hd, Dd, Dd, Wwf, Dd, Dd, Dd, Rd, Rd, Dd, Dd, Dd, Dd, Dd, Dd, Dd^Edp, Dd, Dd, Dd, Dd, Dd, Dd, Dd, Hd, Hd, Hd, Hd, Hd, Hd, Dd, Dd, Dd, Dd, Hd, Dd, Dd, Dd
Dd, Dd, Dd^Edp, Dd, Dd, Dd, Dd^Edp, Dd, Hd, Hd, Hd, Dd, Dd, Dd, Dd, Dd, Hd, Dd, Rd, Dd, Dd, Dd, Dd, Dd, Dd, Dd^Esd, Dd, Dd, Hd, Hd, Hd, Hd, Hd, Dd, Dd, Dd, Dd, Dd, Dd, Dd, Dd
Dd, Dd, Hd, Dd, Hd, Dd^Esd, Dd, Hd, Hd, Hd, Hd, Hd, Dd, Dd^Edp, Ds, Dd, Dd, Dd, Hd, Rd, Dd, Dd, Dd, Ds, Ds, Dd, Dd, Dd, Hd, Hd, Hd, Hd, Hd, Dd, Dd, Hd, Ds, Ds, Dd, Dd, Dd
Dd, Dd, Hd, Hd, Hd, Dd, Dd, Dd, Dd, Dd, Dd, Dd, Hd, Hd, Dd, Ds, Dd, Dd, Dd, Rd, Dd, Dd, Dd^Es, Dd, Dd, Dd, Dd, Dd, Dd, Hd, Hd, Hd, Hd, Dd, Dd, Dd^Es, Ds^Edp, Ds, Hd, Dd, Dd
Hd, Hd, Hd, Hd, Hd, Hd, Hd, Dd, Hd, Dd, Hd, Hd, Hd, Hd, Hd, Dd, Dd, Hd, Dd, Dd, Dd, Dd, Dd, Dd, Dd, Dd^Do, Dd, Dd, Dd, Hd, Hd, Hd, Hd, Hd, Dd, Dd, Dd, Dd, Hd, Dd, Dd
Hd, Dd, Hhd, Hd, Hhd, Hhd, Hd, Hd, Hd, Hd, Hd, Hd, Hd, Hd, Hd, Hd, Dd, Dd, Dd, Dd, Hd, Dd, Rd, Dd, Dd, Dd, Dd, Dd, Dd, Hd, Hd, Hd, Hd, Hd, Hd, Dd, Dd, Hd, Dd, Dd, Dd
Hhd, Hhd, Hhd, Hhd, Md, Hhd, Md, Hhd, Md, Hhd, Hhd, Hhd, Hhd, Hd, Hd, Hd, Hd, Dd, Dd, Hd, Dd, Dd, Dd, Dd, Dd, Dd, Dd, Dd, Ds^Edp, Dd, Dd, Hd, Hd, Hd, Hd, Dd, Dd, Dd, Dd^Esd, Dd, Dd
Md, Hhd, Md, Md, Md, Md, Md, Md, Md, Md, Hhd, Hhd, Hd, Hd, Dd, Hd, Hd, Hd, Dd, Dd, Ds, Ds, Ds, Dd, Dd, Dd, Dd, Dd, Dd, Ds, Dd, Dd, Dd, Hd, Hd, Hd, Dd, Dd, Dd, Dd, Dd
Hhd, Md, Hhd, Md, Hhd, Hhd, Hhd, Hhd, Hhd, Hhd, Md, Hhd, Hhd, Hd, Hd, Hd, Hd, Dd, Dd, Hd, Dd, Ds, Dd, Dd, Dd, Dd, Rd, Dd, Dd, Ds, Dd, Dd, Dd, Dd, Dd, Hd, Hd, Dd, Hd, Hd, Hd
Hhd, Hhd, Hhd, Hhd, Hhd, Hhd, Hhd, Hhd, Hhd, Hhd, Hhd, Hhd, Hhd, Hhd, Hhd, Hd, Dd, Dd, Hd, Dd, Dd^Esd, Dd, Dd, Dd, Dd, Dd, Dd, Rd, Dd, Dd, Dd, Dd, Dd, Dd, Dd, Dd, Dd, Dd, Dd, Dd, Dd
Dd, Hhd, Hhd, Hhd, Hhd, Hhd, Hhd, Hhd, Hhd, Hd, Hd, Hd, Dd, Dd, Dd, Dd, Hd, Dd, Hd, Hd, Dd, Dd, Dd, Dd^Edp, Dd, Dd^Es, Dd, Dd, Dd, Dd, Rd, Dd, Dd, Dd, Dd, Dd^Esd, Dd, Dd, Ds, Dd, Dd
Hd, Hd, Hd, Dd, Hd, Hd, Hd, Hhd, Hd, Dd, Dd, Hd, Hd, Hd, Hd, Hd, Dd, Dd, Dd, Dd, Dd, Dd, Dd, Dd, Dd, Dd, Dd, Ds, Dd, Dd, Dd, Rd, Dd, Dd^Edp, Dd, Dd, Ds^Edp, Ds, Ds, Dd, Dd
Hd, Hd, Dd, Hd, Hd, Hd, Hd, Hd, Dd, Dd, Dd, Dd, Dd, Dd, Hd, Dd, Dd, Dd, Hd, Dd, Dd, Dd, Ds, Dd, Dd, Dd, Dd, Dd, Dd, Dd^Edp, Dd, Rd, Gd, Dd, Dd, Dd, Dd, Ds, Ds, Dd, Dd
Dd, Dd, Dd, Hd, Hd, Hd, Hd, Dd, Dd, Hd, Dd, Hd, Dd, Dd, Dd, Dd, Dd, Hd, Dd, Dd, Dd, Ds, Dd, Dd, Dd, Dd, Dd, Dd, Dd, Dd^Edp, Dd, Gd^Edp, Wwf, Gs, Gd^Ftd, Dd, Dd, Ds, Ds, Dd, Dd
Dd, Dd, Dd, Dd, Hd, Hd, Dd, Hd, Dd, Dd, Hd, Dd, Dd, Dd, Dd, Dd, Dd, Dd, Dd, Dd, Dd^Edp, Dd, Dd, Dd, Dd, Dd, Dd, Dd, Dd^Edp, Dd, Dd, Gs, Wwt, Wwt, Gs, Dd, Dd, Ds^Edp, Ds, Ds, Dd
Dd, Dd, Dd, Dd, Dd, Dd, Dd, Dd, Dd, Dd, Dd, Dd, Dd, Dd, Dd, Dd, Dd, Dd, Dd, Dd, Dd, Dd, Dd, Dd, Dd^Esd, Dd, Dd, Dd, Dd, Dd, Rd, Gs^Edp, Wwt, Wwt, Wwt, Dd^Edp, Dd, Dd, Dd, Ds, Dd
Dd, Dd^Es, Dd, Dd, Dd, Dd, Dd, Dd, Dd, Dd, Dd, Dd, Ds, Dd, Dd, Dd, Dd, Ds, Dd, Dd, Dd, Dd, Ds, Dd, Dd^Es, Dd, Dd, Dd, Rd, Dd, Dd, Wwt, Wwt, Wwt, Dd^Edp, Dd, Dd, Dd^Edp, Dd, Dd, Dd
Dd, Dd, Dd, Dd, Dd, Dd, Dd, Dd, Dd, Dd, Dd, Ds, Dd, Ds, Dd, Dd, Dd, Dd, Dd, Dd, Dd^Do, Ds, Dd, Dd, Dd, Dd, Dd, Rd, Dd, Dd, Dd, Dd, Dd, Dd, Dd, Dd, Dd^Edp, Dd, Dd, Dd, Dd
Dd, Dd, Dd, Ds, Ds, Ds, Dd, Dd, Dd, Dd, Dd, Dd^Esd, Dd, Dd, Dd, Dd, Hd, Hd, Hd, Dd, Dd, Dd, Dd, Dd, Dd, Dd, Dd, Dd, Dd, Dd, Dd, Dd^Edp, Dd, Dd, Dd, Dd, Dd, Dd, Dd, Dd, Dd
Dd, Dd, Dd, Dd, Dd^Esd, Dd, Dd, Dd, Dd, Dd, Dd, Dd, Dd, Dd, Dd, Dd, Dd, Hd, Hd, Dd, Rd, Rd, Dd, Dd, Hd, Dd, Hd, Dd, Hd, Dd, Dd, Dd, Dd, Dd, Dd, Dd, Dd, Dd, Dd, Dd, Dd
Dd, Dd, Dd, Dd, Dd, Dd, Dd, Dd, Dd, Ds, Ds, Ds, Ds, Ds, Dd, Dd, Dd, Dd, Dd, Dd, Dd, Ds, Dd, Dd, Hhd, Hd, Hhd, Hd, Hd, Dd, Dd, Dd, Dd, Dd, Ds, Dd, Dd, Dd, Dd, Dd, Dd
Dd, Dd, Hd, Dd, Dd, Dd, Dd, Dd, Dd, Dd, Dd, Dd, Dd, Dd, Dd, Dd, Dd, Dd, Dd, Dd, Dd, Dd, Hd, Dd, Hhd, Hd, Hhd, Hd, Hd, Dd, Dd, Ds, Ds, Ds^Esd, Dd, Ds, Dd, Dd, Dd, Dd, Dd
Dd, Dd, Dd, Dd, Hd, Dd, Dd, Hd, Dd, Dd, Dd, Dd, Dd, Dd, Rd, Rd, Dd, Dd, Dd, Dd, Dd, Dd, Hd, Hd, Hhd, Md, Md, Hhd, Dd, Hd, Dd, Dd, Dd, Dd, Dd, Dd, Dd, Dd, Dd, Hd, Hd
Dd, Dd, Hd, Dd, Dd, Dd, Dd, Dd, Rd, Rd, Dd, Rd, Dd, Rd, Dd, Dd, Dd, Dd, Dd^Es, Dd, Dd, Hd, Hhd, Hhd, Md, Md, Md, Hhd, Hhd, Dd, Dd, Dd, Dd, Dd, Dd, Dd, Dd, Hd, Dd, Hd, Hhd
Dd, Dd, Dd, Dd, Gd, Dd, Dd, Dd, Dd, Dd, Ce, Dd, Dd, Dd, Hd, Dd, Dd, Dd, Dd, Dd, Dd, Hd, Hd, Hhd, Dd, Md, Hhd, Hhd, Hhd, Hd, Hd, Dd, Dd, Dd, Hd, Hd, Hd, Dd, Hhd, Hhd, Hhd
Dd, Dd, Gs^Ftd, Wwt, Wwt, Gs, Dd, Dd, Dd, Ce, 1 Ke, Ce, Dd, Dd, Dd, Dd, Dd, Dd, Ds, Dd, Dd, Dd, Hd, Hd, Hhd, Hhd, Hhd, Hhd, Hhd, Hd, Hd, Hd, Hd, Dd, Hd, Hd, Hd, Hhd, Hhd, Hhd, Hhd
Dd, Dd, Wwt, Wwt, Wwt, Gs, Dd, Dd, Dd, Ce, Ce, Ce, Dd, Dd, Dd, Dd, Dd, Ds, Dd, Dd, Dd, Dd, Dd, Hd, Hd, Hhd, Dd, Dd, Hd, Hhd, Hhd, Hd, Hhd, Hd, Hhd, Hhd, Hhd, Hhd, Md, Md, Hhd
Dd, Dd, Dd, Wwt, Dd, Dd, Dd, Dd, Dd, Dd, Dd, Dd, Dd, Dd, Dd, Hd, Dd, Dd, Dd, Dd, Dd, Dd, Dd, Dd, Hd, Hhd, Hhd, Hd, Hhd, Hhd, Hd, Hhd, Hhd, Dd, Hhd, Hhd, Hhd, Hhd, Md, Md, Md
Dd, Dd, Dd, Dd, Ds, Dd, Ds^Esd, Dd, Dd, Dd, Dd, Dd, Dd, Dd, Dd, Dd, Dd, Dd, Dd, Dd^Esd, Dd, Dd, Dd, Dd, Dd, Hd, Hd, Hhd, Dd, Hhd, Hd, Hhd, Hhd, Hhd, Hhd, Hhd, Hd, Hhd, Md, Md, Hhd
Dd, Dd, Ds, Ds, Dd, Ds, Ds, Dd, Dd, Dd, Dd, Dd, Dd, Dd, Dd, Dd, Dd, Dd, Dd, Dd, Dd, Dd, Dd, Dd, Dd, Dd, Dd, Hd, Dd, Dd, Dd, Hd, Hd, Hhd, Hd, Hd, Hhd, Hhd, Hhd, Hhd, Hd
