border_size=1
usage=map

Rd, Rd, Rd, Hhd, Hhd, Hhd, Hhd, Hhd, Hhd, Hhd, Hhd, Hhd, Hhd, Hhd, Hd, Hd, Dd, Dd, Dd, Dd, Dd, Dd, Dd, Dd, Dd, Ds, Ds, Ds
Rd, Rd, Rd, Hhd, Hhd, Hhd, Hhd, Hhd, Hhd, Hhd, Hhd, Hhd, Hhd, Hhd, Hd, Hd, Ds, Ds^Edp, Dd, Dd, Dd, Dd, Dd, Dd, Dd, Dd^Edp, Dd, Ds
Hhd, Hhd, Hhd, Rd, Hhd, Hhd, Hhd, Hhd, Dd^Edp, Dd, Hhd, Hhd, Hhd, Dd, Ds, Dd, Dd, Dd, Dd, Dd^Es, Dd, Dd^Edp, Dd, Dd, Dd, Dd, Dd, Ds
Hhd, Hhd, Hhd, Rd, Hhd, Hhd, Hhd, Hhd, Hhd, Hhd, Hhd, Hhd, Hd, Hd, Dd, Ds, Hd, Hd, Hd, Dd, Dd, Dd, Dd^Es, Dd, Hd, Dd^Esd, Dd, Dd
Hhd, Hhd, Hhd, Rd, Rd, Hhd, Hhd, Hhd, Hhd, Hhd, Hhd, Hhd, Dd, Dd^Edp, Dd, Dd, Hd, Hd, Dd, Dd, Dd, Dd, Dd, Hd, Hd, Dd, Dd, Dd
Hhd, Hhd, Hhd, Hhd, Hhd, Rd, Dd, Hhd, Hhd, Hhd, Hd, Dd, Dd, Dd, Dd^Es, Dd, Dd, Hd, Dd, Dd, Dd, Dd, Cyd, Hd, Dd, Dd^Es, Dd, Dd
Hhd, Hhd, Hhd, Dd^Edp, Rd, Rd, Hhd, Hhd, Hhd, Hhd, Dd, Dd, Hd, Dd, Hd, Dd, Dd, Dd, Ds, Ds, Dd, Dd^Es, Cyd, 3 Kyd, Cyd, Dd, Dd, Dd
Hhd, Hhd, Hhd, Dd, Rd, Hhd, Hhd, Hhd, Hhd, Hhd, Dd, Hd, Hd, Hd, Hd, Dd, Dd, Ds, Dd^Edp, Ds, Dd^Es, Dd, Cyd, Cyd, Dd, Dd, Dd, Dd
Hhd, Hhd, Hhd, Hhd, Hhd, Rd, Rd, Rd, Dd, Dd, Ds, Dd, Hd, Hd, Hd, Hd, Dd^Es, Dd, Dd, Dd, Dd, Dd, Dd, Hd, Hd, Dd^Es, Dd, Dd
Hhd, Hhd, Hhd, Hhd, Hhd, Hhd, Rd, Rd, Dd, Ds, Dd, Hd, Hd, Hd, Hd, Hd, Dd, Dd, Dd, Dd^Esd, Dd, Dd, Dd, Hd, Dd, Dd, Dd, Dd
Hhd, Hhd, Dd, Hhd, Hhd, Hhd, Dd, Dd, Dd^Es, Dd, Dd, Dd, Dd, Dd, Dd^Ecf, Hd, Dd^Vdt, Dd, Dd, Dd, Ds, Ds^Es, Dd, Dd, Dd, Dd^Edp, Dd, Dd
Hhd, Hhd, Hhd, Hhd, Hhd, Hhd, Dd, Dd^Edp, Ds, Dd, Dd, Dd, Hd, Hd, Hd, Hd, Dd, Dd, Dd^Esd, Ds, Ds, Dd, Dd, Dd, Hd, Dd, Dd, Dd
Hhd, Hhd, Hhd, Hhd, Dd^Edp, Dd, Hd, Dd, Ds, Dd, Dd, Dd^Vdt, Hd, Hd, Dd, Dd, Dd, Dd, Dd, Ds^Vdt, Dd, Dd, Dd, Dd, Hd, Dd, Dd, Dd
Hhd, Hhd, Hhd, Dd, Dd, Hd, Hd, Hd, Dd, Dd^Esd, Dd, Hd, Dd, Dd, Dd, Ds^Vdt, Ds, Dd, Dd, Dd, Hd, Hd, Dd, Dd, Hd, Hd, Hd, Hd
Hhd, Hhd, Dd^Edp, Dd, Dd^Edp, Dd, Dd, Hd, Dd, Ds, Ds, Dd, Dd, Dd, Dd, Ds, Ds, Dd, Dd^Esd, Dd, Hd, Dd^Vdt, Dd, Dd^Esd, Hd, Hd, Hd, Hd
Hhd, Hhd, Dd, Hd, Dd, Dd, Ce, Dd, Dd, Ds^Ftd, Wwt, Dd^Ftd, Dd, Dd, Dd, Dd, Dd^Ecf, Dd, Dd, Dd, Dd, Dd, Dd, Dd, Dd, Hd, Hd, Hd
Dd, Dd, Dd, Dd^Es, Dd, Ce, 1 Ke, Ce, Dd, Wwt, Wwt, Wwt, Dd, Dd^Vdt, Dd, Dd, Dd, Dd, Dd^Vdt, Dd, Dd^Es, Ds, Ds, Dd, Dd, Hd, Hd, Hd
Dd, Dd, Hd, Dd, Dd, Ce, Ce, Ce, Dd, Dd^Ftd, Wwt, Wwt, Dd^Ftd, Dd, Dd, Dd^Es, Dd, Dd, Dd, Dd, Dd, Dd, Ds, Dd^Esd, Dd, Dd, Dd, Dd
Dd, Dd, Dd, Dd, Ds, Dd, Dd, Dd^Es, Dd, Dd, Dd^Ftd, Wwt, Dd, Dd, Ds^Vdt, Ds, Dd, Dd, Dd, Dd^Vdt, Dd, Dd, Hd, Dd, Dd, Dd^Edp, Dd, Dd
Dd, Dd, Dd, Dd, Ds, Dd, Dd, Ds, Dd, Dd, Dd^Vdt, Dd, Dd, Dd, Dd, Ds, Ds, Dd, Dd, Dd, Hd, Hd, Hd, Dd, Ds, Ds, Dd, Dd
Dd^Edp, Dd, Hd, Dd, Dd, Dd^Es, Dd, Dd, Dd, Dd, Dd, Dd, Dd, Dd^Ecf, Dd, Dd^Es, Dd, Dd^Vdt, Dd, Dd, Dd, Hd, Dd, Dd, Ds^Esd, Dd, Dd^Edp, Dd
Dd, Dd, Dd, Dd^Esd, Dd, Dd, Dd, Dd, Dd^Esd, Dd, Hd, Dd, Hd, Hd, Hd, Dd, Dd, Dd, Dd^Esd, Dd, Dd, Dd^Es, Dd, Ds, Dd, Dd, Dd, Dd
Dd, Dd^Edp, Dd, Dd, Dd, Dd^Edp, Ds, Dd^Es, Dd, Dd, Hd, Hd, Hd, Dd^Vdt, Hd, Dd, Dd, Dd, Dd^Es, Dd, Cyd, Dd, Dd, Ds^Es, Dd^Edp, Ds, Dd, Dd
Dd, Dd, Dd^Edp, Dd, Ds, Ds, Dd, Dd, Ds, Dd, Dd, Hd, Hd, Hd, Dd, Dd, Hd, Hd, Dd, Dd, Cyd, Cyd, Cyd, Dd, Dd, Dd, Dd, Dd
Hd, Hd, Hd, Dd, Dd, Ds^Esd, Dd, Dd, Dd, Ds, Dd, Hd, Dd, Hd, Dd, Dd, Dd, Hd, Dd, Dd, Cyd, 2 Kyd, Dd, Dd, Hd, Hd, Dd, Dd
Hd, Hd, Hd, Hd, Hd, Dd, Dd^Esd, Dd^Edp, Dd, Dd, Dd, Dd^Esd, Dd, Dd, Dd, Dd^Es, Dd, Dd, Dd, Dd^Es, Dd, Dd, Dd, Dd, Dd^Es, Hd, Dd, Dd
Hd, Hd, Hd, Hd, Hd, Dd, Dd, Dd, Dd, Dd^Es, Dd, Ds, Dd, Dd^Edp, Dd, Dd, Dd, Dd, Dd, Ds, Ds^Edp, Dd, Ds, Dd, Dd, Dd, Dd, Dd
Hd, Hd, Hd, Hd, Hd, Dd, Dd, Dd, Dd, Ds, Dd, Dd, Dd, Dd, Dd, Dd, Dd, Dd^Esd, Dd, Ds, Ds, Ds, Ds, Ds, Ds, Dd, Dd, Dd
