border_size=1
usage=map

Xu, Xu, Xu, Xu, Xu, Xu, Xu, Xu, Xu, Xu, Xu, Xu, Xu, Xu, Xu, Xu, Xu, Xu, Xu, Xu, Xu, Xu, Xu, Xu, Xu, Xu, Xu, Xu, Xu, Xu, Uh, Ur, Ur, Uh, Xu, Xu, Xu, Xu, Xu, Xu, Xu, Xu, Xu, Xu, Xu, Wog, Wog, Xu, Xu, Xu, Xu, Xu, Xu, Xu, Xu, Xu, Xu, Xu, Xu, Xu, Xu, Xu, Xu, Xu, Xu, Xu, Xu
Xu, Xu, Xu, Xu, Xu, Xu, Xu, Xu, Xu, Xu, Xu, Xu, Xu, Xu, Xu, Xu, Xu, Xu, Xu, Xu, Xu, Xu, Xu, Xu, Xu, Xu, Xu, Xu, Xu, Xu, Uh, Ur^Es, Ur, Uu^Em, Uh, Xu, Xu, Xu, Xu, Xu, Xu, Xu, Xu, Xu, Xu, Xu, Wog, Wog, Xu, Xu, Xu, Xu, Xu, Xu, Xu, Xu, Xu, Xu, Xu, Xu, Xu, Xu, Xu, Xu, Xu, Xu, Xu
Xu, Xu, Xu, Xu, Xu, Xu, Xu, Xu, Xu, Xu, Xu, Xu, Xu, Xu, Xu, Xu, Xu, Xu, Xu, Xu, Xu, Xu, Xu, Xu, Xu, Wwg, Wwg, Xu, Wwf, Wwf, Ur, Ur, Uu, Uu^Em, Xu, Xu, Xu, Xu, Xu, Xu, Xu, Xu, Xu, Xu, Xu, Wwg, Wwg, Wog, Xu, Xu, Xu, Xu, Xu, Xu, Xu, Xu, Xu, Xu, Xu, Xu, Xu, Xu, Xu, Xu, Xu, Xu, Xu
Xu, Xu, Xu, Xu, Xu, Xu, Xu, Xu, Uu, Uh, Uu, Xu, Uh, Xu, Xu, Xu, Xu, Xu, Xu, Xu, Xu, Xu, Xu, Xu, Xu, Xu, Wwg, Wwg, Xu, Wwf, Ur, Uu, Xu, Xu, Xu, Xu, Xu, Xu, Xu, Xu, Xu, Xu, Xu, Xu, Wwf, Wwg, Wwg, Xu, Xu, Xu, Xue, Xu, Xu, Xu, Xu, Xu, Xu, Xu, Xu, Xu, Xu, Xu, Xu, Xu, Xu, Xu, Xu
Uu, Uu, Uu, Xu, Uu, Uu, Xu, Xu, Uh, Uh, Ce, Uu, Uu, Uu, Xu, Xu, Xu, Xu, Xu, Xu, Xu, Xu, Xu, Xu, Xu, Xu, Xu, Xu, Xu, Wwf, Wwf, Uu, Wwf, Xu, Xu, Xu, Xu, Xu, Xu, Xu, Xue, Xu, Xu, Rb^Uf, Rb, Wwf, Wwf, Xu, Xu, Xue, Uue, Xue, Xue, Xu, Xu, Xu, Xu, Xu, Xu, Xu, Xu, Xu, Xu, Xu, Xu, Xu, Xu
Xu, Uu, Xu, Uu, Uu, Uu, Uu, Uu, Uu, Ce, 1 Ke, Ce, Uu, Xu, Uu, Xu, Xu, Xu, Xu, Xu, Xu, Xu, Xu, Xu, Xu, Xu, Xu, Xu, Uu^Uf, Ur, Wwf, Wwf, Wwg, Xu, Xu, Xu, Xu, Xu, Xu, Xue, Rb, Xue, Rb^Em, Rb, Rb^Uf, Rb, Xu, Xu, Uu^Em, Xue, Uue^Es, Uue, Xu, Xu, Xu, Xu, Xu, Xu, Xu, Xu, Xu, Xu, Xu, Xu, Xu, Xu, Xu
Xu, Xu, Xu, Xu, Uh, Uu, Uh, Uu, Uu, Uu, Uu, Ce, Uu, Uu, Re, Xu, Xu, Xu, Uu, Xu, Xu, Xu, Xu, Xu, Xu, Xu, Uu^Vu, Uu, Ur, Ur^Es, Uu, Xu, Wwg, Wwg, Xu, Xu, Xu, Xu, Xu, Xue, Uue^Uf, Uue, Ur, Re, Xue, Rb, Xu, Xu, Rb, Uu, Xu, Uu, Xu, Xu, Xu, Xu, Xu, Xu, Xu, Xu, Xu, Xu, Xu, Xu, Xu, Xu, Xu
Xu, Xu, Xu, Xu, Xu, Uh, Xu, Uh, Uu, Uh, Uh, Uu, Xu, Uu, Xu, Re, Xu, Uh, Uu, Xu, Xu, Xu, Uu, Xu, Cud, Uu, Uu, Uu, Ur^Es, Uu, Xu, Xu, Wwf, Xu, Xu, Xu, Re, Xu, Xu, Xue, Ur^Es, Ur, Uue, Uue, Re, Xu, Re, Rb, Rb, Uu, Xu, Xu, Xu, Xu, Xu, Xu, Xu, Xu, Xu, Xu, Xu, Xu, Xu, Xu, Xu, Xu, Xu
Xu, Xu, Xu, Xu, Xu, Xu, Xu, Xu, Xu, Xu, Xu, Uu, Xu, Xu, Xu, Xu, Xu, Uu, Uu^Uf, Uh, Xu, Xu, Uu, Uu, Uu, Uu, Ur, Ur, Uu, Uu^Uf, Xu, Wwf, Xu, Xu, Xu, Xu, Re^Es, Re, Ur, Ur, Uue, Ur, Ur, Ur, Ur, Ur, Rb^Es, Xu, Xu, Xu, Xu, Xu, Xu, Xu, Xu, Xu, Xu, Xu, Xu, Xu, Xu, Xu, Xu, Xu, Xu, Xu, Xu
Xu, Xu, Xu, Xu, Xu, Xu, Xu, Xu, Xu, Xu, Xu, Xu, Xu, Xu, Xu, Xu, Xu, Xu, Uh, Uh, Uh, Uu^Es, Uu, Uu, Cud, Uu, Ur, Ur, Uu, Uu, Wwg, Wwg, Wwf, Uu, Uu, Re, Re, Ur, Uue, Ur, Re, Uue^Em, Re, Uue, Xue, Re, Xu, Xu, Xu, Xu, Xu, Xu, Xu, Xu, Xu, Xu, Xu, Xu, Xu, Xu, Xu, Xu, Xu, Xu, Xu, Xu, Xu
Xu, Xu, Xu, Xu, Xu, Xu, Xu, Xu, Xu, Xu, Xu, Xu, Xu, Xu, Xu, Xu, Xu, Xu, Uu, Uh, Uu, Uu, Uu, Xu, Xu, Xu, Xu, Wwf, Wwf, Uu^Vu, Wwg, Wwf, Uu^Es, Uu, Uu^Em, Re, Xu, Xu, Xu, Xu, Xu, Re, Xu, Re, Xu, Xu, Xu, Xu, Xu, Xu, Xu, Xu, Xu, Xu, Xu, Xu, Xu, Xu, Xu, Xu, Xu, Xu, Xu, Xu, Xu, Xu, Xu
Xu, Xu, Xu, Xu, Xu, Xu, Xu, Xu, Xu, Xu, Xu, Xu, Xu, Xu, Xu, Xu, Xu, Xu, Xu, Xu, Xu, Uu, Xu, Xu, Xu, Wwf, Wwg, Wwg, Uu, Wwf, Wwf, Uu, Uu, Uu, Uu, Uu, Xu, Xu, Xu, Xu, Xu, Xu, Xu, Xu, Xu, Xu, Xu, Xu, Xu, Xu, Xu, Xu, Xu, Xu, Xu, Xu, Xu, Xu, Xu, Xu, Xu, Xu, Xu, Xu, Xu, Xu, Xu
Xu, Xu, Xu, Xu, Xu, Xu, Xu, Xu, Xu, Xu, Xu, Xu, Xu, Xu, Xu, Xu, Xu, Xu, Xu, Xu, Xu, Xu, Xu, Xu, Xu, Wwg, Xu, Xu, Uu, Uu, Cud, Uu, Uu, Xu, Xu, Xu, Xu, Xu, Xu, Xu, Xu, Xu, Xu, Xu, Xu, Xu, Xu, Xu, Xu, Xu, Xu, Xu, Xu, Xu, Xu, Xu, Xu, Xu, Xu, Xu, Xu, Xu, Xu, Xu, Xu, Xu, Xu
Xu, Xu, Xu, Xu, Xu, Xu, Xu, Xu, Xu, Xu, Xu, Xu, Xu, Xu, Xu, Xu, Xu, Xu, Xu, Xu, Qxu, Xu, Xu, Xu, Wwg, Wwg, Xu, Uu, Uu, Cud, Kud, Cud, Uu, Uu, Uu, Xu, Xu, Xu, Xu, Xu, Xu, Xu, Xu, Xu, Xu, Xu, Xue, Xu, Xue, Xu, Xu, Xu, Xu, Xu, Xu, Xu, Xu, Xu, Xu, Xu, Xu, Xu, Xu, Xu, Xu, Xu, Xu
Xu, Xu, Xu, Xu, Xu, Xu, Xu, Xu, Xu, Xu, Xu, Xu, Xu, Xu, Xu, Xu, Xu, Xu, Xu, Qxu, Qxu, Qxu, Qxu, Qxu, Qxu, Wwg, Xu, Uu, Uu^Es, Cud, Ur, Cud, Uu, Uu, Uh, Xu, Xu, Xu, Xu, Xu, Xu, Xu, Qxu, Xu, Xu, Xue, Uue, Xue, Uue^Uf, Xue, Xue, Xu, Xu, Xu, Xu, Xu, Xu, Xu, Xu, Xu, Xu, Xu, Xu, Xu, Xu, Xu, Xu
Xu, Xu, Xu, Xu, Xu, Xu, Xu, Xu, Xu, Xu, Xu, Xu, Xu, Xu, Xu, Xu, Xu, Xu, Xu, Qxu, Qxu, Xu, Qxu, Xu, Xu, Xu, Xu, Xu, Uu, Uu, Uu, Ur, Uu, Uh, Uh, Xu, Xu, Xu, Xu, Xu, Qxu, Xu, Qxu, Xu, Xu, Xue, Xue, Rb^Em, Rb, Uue, Xu, Xu, Xu, Xu, Xu, Xu, Xu, Xu, Wog, Xu, Xu, Xu, Xu, Xu, Xu, Xu, Xu
Xu, Xu, Xu, Xu, Xu, Xu, Xu, Xu, Xu, Xu, Uu, Xu, Uu, Xu, Xu, Xu, Uu, Qxu, Qxu, Qxu, Qxu, Xu, Xu, Xu, Wwf, Wwf, Xu, Xu, Xu, Xu, Xu, Ur, Ur, Uh, Uu, Uh, Xu, Xu, Xu, Xu, Qxu, Qxu, Xu, Xu, Rb, Wwf, Wwg, Wwf, Rb^Em, Xu, Xu, Xu, Xu, Xu, Xu, Xu, Wog, Xu, Wwg, Wog, Wwg, Xu, Wog, Wog, Xu, Xu, Xu
Xu, Xu, Xu, Xu, Xu, Xu, Xu, Xu, Xu, Uu, Uu, Uu, Uu, Uu, Uu^Em, Xu, Uu, Qxu, Qxu, Qxu, Xu, Xu, Xu, Xu, Wwf, Qxu, Qxu, Xu, Xu, Xu, Uu, Uu, Uu, Uu, Uu, Uu, Uu, Xu, Xu, Qxu, Qxu, Qxu, Wwf, Xu, Wwf, Wwg, Wwg, Wwg, Wwf, Xu, Wwf, Xu, Xu, Xu, Wwg, Wog, Wwg, Wwg, Wwg, Wwg, Wwg, Wwg, Wwg, Wwg, Wwg, Xu, Xu
Xu, Xu, Xu, Xu, Xu, Xu, Xu, Xu, Xu, Uu, Uu^Em, Qxu, Qxu, Uu, Qxu, Uu, Qxu, Qxu, Qxu, Qxu, Ql, Xu, Xu, Xu, Xu, Xu, Qxu, Xu, Xu, Xu, Xu, Xu, Uh, Uh, Uu^Es, Uu, Qxu, Xu, Qxu, Qxu, Xu, Wwf, Re^Uf, Wwf, Rb, Rb^Em, Rb^Uf, Xu, Wwf, Wwf, Xu, Wwf, Xu, Xu, Wwg, Wwg, Uu, Wwg, Uu, Wwf, Uh, Wwg, Uh, Wwg, Wog, Xu, Xu
Xu, Xu, Xu, Xu, Xu, Xu, Uu, Uu, Uu^Es, Uu, Qxu, Qxu, Qxu, Qxu, Qxu, Qxu, Qxu, Qxu, Qxu, Ql, Xu, Xu, Xu, Xu, Xu, Qxu, Qxu, Qxu, Xu, Xu, Xu, Xu, Xu, Uh, Uu, Uu, Uu, Qxu, Qxu, Qxu, Qxu, Xu, Rb^Em, Rb, Xue, Uue, Xu, Xu, Xu, Xu, Xu, Xu, Xu, Wwg, Wwg, Wwf, Uu, Uu, Cud, Uu, Uu, Uh, Wwf, Wwg, Wog, Wog, Xu
Xu, Xu, Xu, Xu, Xu, Xu, Uu, Qxu, Qxu, Uu, Qxu, Qxu, Ur, Qxu, Qxu, Qxu, Uu, Qxu, Uu, Ql, Ql, Xu, Xu, Xu, Xu, Qxu, Qxu, Xu, Xu, Xu, Qxu, Xu, Qxu, Qxu, Qxu, Ur, Ur, Qxu, Uu, Qxu, Qxu, Xue, Uue, Uue, Xue, Xu, Uu, Xu, Qxu, Xu, Xu, Xu, Xu, Wwg, Wwf, Uu^Em, Uu, Cud, Kud, Cud, Uu, Uu, Uh, Wwg, Wwg, Xu, Xu
Xu, Xu, Xu, Xu, Xu, Xu, Qxu, Qxu, Qxu, Qxu, Qxu, Qxu, Ur, Ur, Ur, Uu, Xu, Uu, Xu, Xu, Ql, Ql, Xu, Xu, Xu, Xu, Qxu, Qxu, Qxu, Xu, Qxu, Qxu, Qxu, Qxu, Uh, Uu^Em, Ur, Uu, Uu, Uu, Uu, Uu, Xu, Xu, Xu, Xu, Qxu, Qxu, Xu, Xu, Xu, Wog, Wwg, Wwg, Uh, Uu, Ur, Cud, Cud, Cud, Uu, Uu, Wwf, Wwg, Wwg, Xu, Xu
Xu, Xu, Xu, Xu, Xu, Xu, Qxu, Qxu, Qxu, Qxu, Qxu, Ur, Ur, Ur^Es, Re, Re, Xu, Uu, Xu, Ql, Ql, Xu, Xu, Xu, Xu, Xu, Xu, Qxu, Qxu, Qxu, Qxu, Xu, Qxu, Uh, Uu, Uu, Uu, Uu, Uu^Es, Qxu, Qxu, Qxu, Qxu, Qxu, Qxu, Qxu, Qxu, Xu, Xu, Xu, Xu, Wog, Wog, Wwg, Uu, Uu, Ur, Ur, Ur, Ur, Uu, Uh, Wwg, Wwg, Xu, Wog, Xu
Xu, Xu, Xu, Xu, Xu, Qxu, Qxu, Qxu, Uu, Uu, Re, Uu, Ur, Ur^Em, Uu, Uu, Uu, Xu, Ql, Ql, Xu, Ql, Xu, Uu^Uf, Uu^Uf, Xu, Xu, Qxu, Xu, Qxu, Xu, Qxu, Qxu, Qxu, Ur^Es, Ur, Uu, Uu^Em, Uu, Qxu, Qxu, Qxu, Qxu, Qxu, Xu, Qxu, Xu, Xu, Xu, Xu, Xu, Wog, Xu, Uu, Ur, Ur^Es, Ur, Ur, Ur^Es, Ur, Uu^Em, Wwg, Wwg, Wog, Xu, Xu, Xu
Xu, Xu, Xu, Xu, Qxu, Xu, Qxu, Qxu, Xu, Xu, Xu, Re, Uu, Ur, Ur, Re^Es, Xu, Xu, Xu, Ql, Xu, Xu, Uu^Uf, Uu^Uf, Uu^Uf, Xu, Xu, Xu, Uh, Xu, Uu, Xu, Uu, Ur^Es, Ur, Ur, Uh, Qxu, Uh, Uu, Wwf, Wwf, Xue, Uue, Xu, Xu, Xu, Xu, Xu, Xu, Xu, Xu, Xu, Xu, Ur, Ur, Ur, Uu, Uu, Uu, Uu^Es, Uu, Uu, Xu, Xu, Xu, Xu
Xu, Xu, Xu, Xu, Qxu, Qxu, Qxu, Qxu, Xu, Xu, Xu, Uu^Es, Re, Re, Ur, Ur, Ur, Xu, Ql, Ql, Ql, Xu, Uu^Uf, Uu, Xu, Xu, Xu, Xu, Uh, Uh, Ur, Uu^Em, Uu, Uu, Xu, Qxu, Qxu, Qxu, Xue, Rb, Rb^Em, Wwf, Xue, Xue, Xue, Xu, Xu, Xu, Xu, Xu, Xu, Xu, Xu, Uu, Ur^Em, Ur, Uu, Xu, Uu, Uu, Uu, Xu, Xu, Xu, Xu, Xu, Xu
Qxu, Qxu, Xu, Xu, Qxu, Qxu, Xu, Qxu, Xu, Xu, Xu, Xu, Uu, Re, Xu, Re, Re^Xo, Xu, Ql, Ql, Xu, Xu, Xu, Uu, Qlf, Qlf, Qlf, Xu, Uu^Es, Ur, Ur, Uu, Xu, Uu, Xu, Qxu, Qxu, Xu, Xu, Xue, Wwf, Wwg, Wwf, Rb^Em, Xu, Xu, Xu, Xu, Xu, Xu, Xu, Uu, Uu, Ur, Ur, Ur, Xu, Xu, Xu, Xu, Xu, Xu, Xu, Xu, Xu, Xu, Xu
Xu, Qxu, Qxu, Qxu, Qxu, Qxu, Ql, Ql, Ql, Xu, Xu, Xu, Xu, Xu, Xu, Xu, Rd, Rd, Rd, Ql, Ql, Xu, Ql, Uu, Uu, Qlf, Qlf, Uu, Ur, Ur, Xu, Uu, Xu, Xu, Xu, Xu, Qxu, Qxu, Xu, Xue, Rb, Wwf, Xue, Rb^Em, Xu, Xu, Xu, Xu, Xu, Uh, Uh, Uu^Vu, Ur, Ur^Es, Uu, Uu, Xu, Xu, Xu, Xu, Xu, Xu, Xu, Xu, Xu, Xu, Xu
Xu, Qxu, Qxu, Qxu, Qxu, Xu, Xu, Xu, Ql, Xu, Xu, Xu, Xu, Xu, Xu, Xu, Rd, Rd^Es, Ql, Ql, Ql, Ql, Uu, Ql, Ur, Uu, Uu^Es, Uu^Em, Uu, Xu, Xu, Xu, Xue, Xue, Xue, Xu, Xu, Qxu, Xu, Xu, Xu, Rb, Xu, Xu, Uu^Vu, Uh, Xu, Xu, Uu^Vu, Uu, Uu^Em, Uu, Ur, Ur, Uu, Uu, Xu, Xu, Xu, Xu, Xu, Xu, Xu, Xu, Xu, Xu, Xu
Xu, Xu, Xu, Xu, Xu, Xu, Xu, Xu, Ql, Ql, Ql, Ql, Ql, Xu, Xu, Rd, Ql, Rd, Rd, Ql, Ql, Uu, Uu, Ur, Uu, Ur, Ur, Ur, Ur, Xu, Xue, Xue, Uue^Em, Rb^Es, Wwg, Xue, Xu, Qxu, Xu, Xu, Xu, Xu, Xu, Uh, Uh, Uh, Uu, Ur, Uu, Uu, Uu, Ur, Ur, Uu, Uh^Uf, Xu, Xu, Xu, Xu, Xu, Xu, Xu, Xu, Xu, Xu, Xu, Xu
Xu, Xu, Xu, Xu, Xu, Xu, Ql, Xu, Xu, Ql, Xu, Ql, Ql, Xu, Xu, Xu, Ql, Ql, Ql, Uue, Uu^Es, Ur, Uue, Qlf, Qlf, Qlf, Qlf, Uu^Es, Uh, Uu, Uue, Uue, Uu^Em, Rb^Em, Uue^Em, Xu, Xu, Xu, Xu, Xu, Xu, Xu, Xu, Uh, Xu, Uh^Uf, Uh^Uf, Ur, Ur, Uu, Ur, Ur, Uu, Uu^Em, Uu^Uf, Uh^Uf, Xu, Xu, Xu, Xu, Xu, Xu, Xu, Xu, Xu, Xu, Xu
Xu, Xu, Xu, Xu, Xu, Xu, Ql, Ql, Ql, Ql, Xu, Xu, Ql, Ql, Ql, Ql, Ql, Ql, Ql, Uu, Uh, Uu, Ur, Uu, Qlf, Qlf, Qlf, Uh, Qlf, Uu, Xu, Xu, Xue, Rb^Es, Xue, Xue, Xu, Xu, Xu, Xu, Xu, Xu, Xu, Xu, Xu, Uu^Uf, Uh^Uf, Uu, Ur, Ur^Es, Ur, Ur, Ur, Uh^Uf, Uh, Xu, Xu, Xu, Xu, Xu, Xu, Xu, Xu, Xu, Xu, Xu, Xu
Xu, Xu, Xu, Xu, Xu, Xu, Xu, Ql, Xu, Ql, Xu, Xu, Xu, Xu, Ql, Xu, Ql, Ql, Ql, Ql, Ql, Ql, Ur, Ur^Em, Uu, Uu, Qlf, Qlf, Uh, Qlf, Xu, Xu, Xu, Xu, Xu, Xu, Xu, Xu, Xu, Xu, Xu, Xu, Xu, Xu, Xu, Xu, Uu^Em, Uu, Ur, Ur, Uu, Uu, Uu^Vu, Ur, Uh, Xu, Uh, Xu, Xu, Xu, Xu, Xu, Xu, Xu, Xu, Xu, Xu
Xu, Xu, Xu, Xu, Xu, Xu, Xu, Xu, Xu, Xu, Xu, Ql, Ql, Ql, Ql, Ql, Ql, Xu, Xu, Ql, Ql, Ql, Ql, Uu, Ur, Ur, Uue, Uu, Uu, Uh, Qlf, Xu, Xu, Xu, Xu, Xu, Xu, Xu, Xu, Xu, Xu, Xu, Xu, Xu, Xu, Uu, Ur, Ur, Uu, Ur, Uu^Vu, Uh, Uu, Uh, Uh, Uu^Vu, Uh, Xu, Xu, Xu, Xu, Xu, Xu, Xu, Xu, Xu, Xu
Xu, Xu, Xu, Xu, Xu, Xu, Xu, Xu, Xu, Ql, Ql, Ql, Ql, Ql, Xu, Xu, Xu, Xu, Ql, Ql, Ql, Ql, Uu^Es, Uu, Uu^Em, Uu, Uu, Uu, Ur^Es, Uu, Qlf, Qlf, Qlf, Xu, Xu, Xu, Xu, Xu, Xu, Xu, Xu, Xu, Uh^Uf, Uu^Uf, Uu, Ur, Uu, Xu, Xu, Uu, Uu, Uh, Xu, Uh, Xu, Uh, Uh, Xu, Xu, Xu, Xu, Xu, Xu, Xu, Xu, Xu, Xu
Xu, Xu, Xu, Xu, Xu, Xu, Xu, Xu, Xu, Ql, Xu, Ql, Ql, Xu, Xu, Xu, Ql, Xu, Ql, Xu, Xu, Ql, Uue, Ql, Ql, Ql, Ql, Ql, Ur, Uu, Uu, Qlf, Qlf, Qlf, Xu, Xu, Xu, Xu, Xu, Xu, Xu, Uh, Uh, Uu^Uf, Xu, Ur, Uu, Xu, Xu, Uh, Uh, Xu, Xu, Uh, Xu, Xu, Xu, Xu, Xu, Xu, Xu, Xu, Xu, Xu, Xu, Xu, Xu
Xu, Xu, Xu, Xu, Xu, Xu, Xu, Xu, Xu, Xu, Xu, Xu, Ql, Ql, Xu, Xu, Ql, Ql, Xu, Xu, Rb^Em, Uue, Xu, Ql, Ql, Ql, Ql, Ql, Uu, Uu, Uu, Uu, Qlf, Qlf, Xu, Xu, Qlf, Xu, Xu, Xu, Xu, Xu, Uu, Uu, Ur, Ur, Uu^Em, Uu, Xu, Xu, Xu, Xu, Xu, Xu, Xu, Xu, Xu, Xu, Xu, Xu, Xu, Xu, Xu, Xu, Xu, Xu, Xu
Xu, Xu, Xu, Xu, Xu, Xu, Xu, Xu, Xu, Xu, Xu, Xu, Xu, Xu, Xu, Xu, Ql, Ql, Xu, Rb^Emf, Wwg, Rb, Xu, Xu, Xu, Xu, Xu, Ql, Ql, Ql, Ql, Ur, Ur^Es, Uu, Uue, Qlf, Qlf, Qlf, Qlf, Qlf, Qlf, Uu^Es, Ur, Ur, Uh, Uu, Uu, Xu, Xu, Xu, Xu, Xu, Xu, Xu, Xu, Xu, Xu, Xu, Xu, Xu, Xu, Xu, Xu, Xu, Xu, Xu, Xu
Xu, Xu, Xu, Xu, Xu, Xu, Xu, Xu, Xu, Xu, Xu, Xu, Xu, Xu, Xu, Ql, Xu, Xu, Xu, Rb^Emf, Rb^Em, Rb^Emf, Xu, Xu, Xu, Xu, Xu, Xu, Xu, Xu, Ql, Uu, Uh, Uu, Uu, Uu, Qlf, Uh, Uu, Qlf, Uu, Ur, Uue^Em, Uu, Uh^Uf, Uh^Uf, Xu, Xu, Xu, Xu, Xu, Xu, Xu, Xu, Xu, Xu, Xu, Xu, Xu, Xu, Xu, Xu, Xu, Xu, Xu, Xu, Xu
Xu, Xu, Xu, Xu, Xu, Xu, Xu, Xu, Xu, Xu, Xu, Xu, Xu, Xu, Xu, Xu, Xu, Xu, Xu, Xu, Xu, Xu, Xu, Xu, Xu, Xu, Xu, Xu, Xu, Xu, Ql, Ql, Ql, Ql, Uu, Uu^Em, Ur, Uu, Ur, Uu, Uu, Uue, Uue, Xu, Xu, Xu, Xu, Xu, Xu, Xu, Xu, Xu, Xu, Xu, Xu, Xu, Xu, Xu, Xu, Xu, Xu, Xu, Xu, Xu, Xu, Xu, Xu
Xu, Xu, Xu, Xu, Xu, Xu, Xu, Xu, Xu, Xu, Xu, Xu, Xu, Xu, Xu, Xu, Xu, Xu, Xu, Xu, Xu, Xu, Xu, Xu, Xu, Xu, Xu, Xu, Xu, Ql, Ql, Ql, Ql, Ql, Xu, Uh, Uu, Ur, Uu, Uu^Es, Qlf, Xu, Xu, Xu, Xu, Xu, Xu, Xu, Xu, Xu, Xu, Xu, Xu, Xu, Xu, Xu, Xu, Xu, Xu, Xu, Xu, Xu, Xu, Xu, Xu, Xu, Xu
Xu, Xu, Xu, Xu, Xu, Xu, Xu, Xu, Xu, Xu, Xu, Xu, Xu, Xu, Xu, Xu, Xu, Xu, Xu, Xu, Xu, Xu, Xu, Xu, Xu, Xu, Xu, Xu, Xu, Xu, Xu, Xu, Xu, Xu, Xu, Uh, Xu, Uu, Uu^Em, Uu, Qlf, Qlf, Xu, Xu, Xu, Xu, Xu, Xu, Xu, Xu, Xu, Xu, Xu, Xu, Xu, Xu, Xu, Xu, Xu, Xu, Xu, Xu, Xu, Xu, Xu, Xu, Xu
Xu, Xu, Xu, Xu, Xu, Xu, Xu, Xu, Xu, Xu, Xu, Xu, Xu, Xu, Xu, Xu, Xu, Xu, Xu, Xu, Xu, Xu, Xu, Xu, Xu, Xu, Xu, Xu, Xu, Xu, Xu, Xu, Xu, Xu, Xu, Xu, Xu, Xu, Xu, Qlf, Qlf, Qlf, Qlf, Xu, Xu, Xu, Xu, Xu, Xu, Xu, Xu, Xu, Xu, Xu, Xu, Xu, Xu, Xu, Xu, Xu, Xu, Xu, Xu, Xu, Xu, Xu, Xu
Xu, Xu, Xu, Xu, Xu, Xu, Xu, Xu, Xu, Xu, Xu, Xu, Xu, Xu, Xu, Xu, Xu, Xu, Xu, Xu, Xu, Xu, Xu, Xu, Xu, Xu, Xu, Xu, Xu, Xu, Xu, Xu, Xu, Xu, Xu, Xu, Xu, Xu, Xu, Qlf, Xu, Qlf, Xu, Xu, Xu, Xu, Xu, Xu, Xu, Xu, Xu, Xu, Xu, Xu, Xu, Xu, Xu, Xu, Xu, Xu, Xu, Xu, Xu, Xu, Xu, Xu, Xu
Xu, Xu, Xu, Xu, Xu, Xu, Xu, Xu, Xu, Xu, Xu, Xu, Xu, Xu, Xu, Xu, Xu, Xu, Xu, Xu, Xu, Xu, Xu, Xu, Xu, Xu, Xu, Xu, Xu, Xu, Xu, Xu, Xu, Xu, Xu, Xu, Xu, Xu, Xu, Xu, Xu, Xu, Xu, Xu, Xu, Xu, Xu, Xu, Xu, Xu, Xu, Xu, Xu, Xu, Xu, Xu, Xu, Xu, Xu, Xu, Xu, Xu, Xu, Xu, Xu, Xu, Xu
Xu, Xu, Xu, Xu, Xu, Xu, Xu, Xu, Xu, Xu, Xu, Xu, Xu, Xu, Xu, Xu, Xu, Xu, Xu, Xu, Xu, Xu, Xu, Xu, Xu, Xu, Xu, Xu, Xu, Xu, Xu, Xu, Xu, Xu, Xu, Xu, Xu, Xu, Xu, Xu, Xu, Xu, Xu, Xu, Xu, Xu, Xu, Xu, Xu, Xu, Xu, Xu, Xu, Xu, Xu, Xu, Xu, Xu, Xu, Xu, Xu, Xu, Xu, Xu, Xu, Xu, Xu
Xu, Xu, Xu, Xu, Xu, Xu, Xu, Xu, Xu, Xu, Xu, Xu, Xu, Xu, Xu, Xu, Xu, Xu, Xu, Xu, Xu, Xu, Xu, Xu, Xu, Xu, Xu, Xu, Xu, Xu, Xu, Xu, Xu, Xu, Xu, Xu, Xu, Xu, Xu, Xu, Xu, Xu, Xu, Xu, Xu, Xu, Xu, Xu, Xu, Xu, Xu, Xu, Xu, Xu, Xu, Xu, Xu, Xu, Xu, Xu, Xu, Xu, Xu, Xu, Xu, Xu, Xu
